SystemId,metervalue,meterDate,solarlog s.no,last transfer date,Device type,may -2021 data,jun- 2021 data,jun - may diff,july- jun diff,capacity,specific yield,Reporting status
24769,79931,2021-07-29T06:02:22,154943594,01/07/2021 10:10,Meter,77275,78898,1623,1033,10.836,3.404656436,TRUE
34280,27788,2021-07-29T06:02:22,1228686035,01/07/2021 10:10,Meter,26840,27420,580,368,4.788,2.744957632,TRUE
24806,60905,2021-07-29T06:02:23,1497120225,01/07/2021 10:10,Meter,59188,60218,1030,687,6.683,3.671362305,TRUE
40523,61013,2021-07-29T06:02:30,423385194,01/07/2021 10:10,Meter,58979,60211,1232,802,7.538,3.799795323,TRUE
40519,32663,2021-07-29T06:02:31,691800612,01/07/2021 10:10,Meter,31630,32254,624,409,4.032,3.622803288,TRUE
40461,34437,2021-07-29T06:02:31,1765553180,01/07/2021 10:10,Meter,33211,33955,744,482,4.536,3.795036533,TRUE
40416,34313,2021-07-29T06:02:31,1765562319,01/07/2021 10:10,Meter,33040,33815,775,498,6.3,2.823129252,TRUE
26472,85897,2021-07-29T06:02:32,154938654,01/07/2021 10:10,Meter,83210,84858,1648,1039,12.636,2.936620992,TRUE
38458,94620,2021-07-29T06:02:32,1497406992,01/07/2021 10:10,Meter,91044,93197,2153,1423,13.041,3.897049963,TRUE
15481,49491,2021-07-29T06:02:32,691808022,01/07/2021 10:10,Meter,47689,48753,1064,738,6.831,3.85846038,TRUE
39524,62604,2021-07-29T06:02:33,423374573,01/07/2021 10:10,Meter,60315,61688,1373,916,8.535,3.832956733,TRUE
27471,66366,2021-07-29T06:02:33,960254315,01/07/2021 10:10,Meter,64246,65509,1263,857,7.56,4.04856387,TRUE
36367,72468,2021-07-29T06:02:34,154946805,01/07/2021 10:10,Meter,70153,71557,1404,911,8.694,3.742318183,TRUE
36366,26461,2021-07-29T06:02:34,423382724,01/07/2021 10:10,Meter,25537,26093,556,368,3.78,3.476946334,TRUE
39155,74189,2021-07-29T06:02:34,154941618,01/07/2021 10:10,Meter,72059,73322,1263,867,8.82,3.51068999,TRUE
38455,42031,2021-07-29T06:02:34,423370621,01/07/2021 10:10,Meter,40461,41419,958,612,6.048,3.613945578,TRUE
57399,26992,2021-07-29T06:02:35,2033989840,01/07/2021 10:10,Meter,25823,26527,704,465,4.536,3.661186697,TRUE
38482,18592,2021-07-29T06:02:35,1228676896,01/07/2021 10:10,Meter,18087,18390,303,202,2.52,2.862811791,TRUE
39012,7843,2021-07-29T06:02:35,960242459,01/07/2021 10:10,Meter,7612,7749,137,94,0.99,3.391053391,TRUE
73937,25316,2021-07-29T06:02:37,1228677884,01/07/2021 10:10,Meter,24260,24924,664,392,4.536,3.086419753,TRUE
39095,74606,2021-07-29T06:02:37,154934208,01/07/2021 10:11,Meter,72137,73623,1486,983,11.0295,3.183022155,TRUE
39094,20291,2021-07-29T06:02:37,1497117755,01/07/2021 10:11,Meter,19511,19982,471,309,3.465,3.184910328,TRUE
39093,16894,2021-07-29T06:02:37,1228676649,01/07/2021 10:11,Meter,16264,16654,390,240,2.475,3.463203463,TRUE
39295,36733,2021-07-29T06:02:38,423370374,01/07/2021 10:11,Meter,35669,36307,638,426,4.347,3.499950705,TRUE
38586,101017,2021-07-29T06:02:40,154935443,01/07/2021 10:11,Meter,97591,99607,2016,1410,12.96,3.885582011,TRUE
39890,52309,2021-07-29T06:02:40,960245176,01/07/2021 10:11,Meter,50444,51585,1141,724,7.1415,3.620687931,TRUE
25910,56931,2021-07-29T06:02:50,423372844,01/07/2021 10:11,Meter,55187,56245,1058,686,6.552,3.739316239,TRUE
39066,29308,2021-07-29T06:02:50,1228690975,01/07/2021 10:11,Meter,28271,28918,647,390,4.617,3.016801262,TRUE
39911,14238,2021-07-29T06:02:50,2033997250,01/07/2021 10:11,Meter,13837,14074,237,164,2.475,2.366522367,TRUE
39922,29525,2021-07-29T06:02:51,154942359,01/07/2021 10:11,Meter,28533,29140,607,385,4.221,3.257521914,TRUE
39891,44540,2021-07-29T06:02:51,154949028,01/07/2021 10:11,Meter,42951,43909,958,631,6.048,3.726143235,TRUE
39905,26813,2021-07-29T06:02:51,423376055,01/07/2021 10:11,Meter,26089,26577,488,236,3.7125,2.27032227,TRUE
27588,58890,2021-07-29T06:02:52,691817161,01/07/2021 10:11,Meter,57098,58191,1093,699,7.839,3.184626319,TRUE
29114,51908,2021-07-29T06:02:52,1497115285,01/07/2021 10:11,Meter,50170,51220,1050,688,6.93,3.545660689,TRUE
36103,21010,2021-07-29T06:02:52,960255056,01/07/2021 10:11,Meter,20284,20726,442,284,3.2175,3.152403152,TRUE
27608,49706,2021-07-29T06:02:52,154949522,01/07/2021 10:11,Meter,48080,49063,983,643,5.94,3.866041366,TRUE
37022,34520,2021-07-29T06:02:53,1228678378,01/07/2021 10:11,Meter,33423,34068,645,452,4.032,4.003684807,TRUE
37367,37560,2021-07-29T06:02:53,2033984900,01/07/2021 10:11,Meter,36571,37150,579,410,4.914,2.979824408,TRUE
26523,40461,2021-07-29T06:02:53,423371856,01/07/2021 10:11,Meter,39072,39899,827,562,5.31,3.779930051,TRUE
37788,92102,2021-07-29T06:02:53,2033983418,01/07/2021 10:11,Meter,89311,91003,1692,1099,11.2455,3.490285003,TRUE
25908,104363,2021-07-29T06:02:54,1228677390,01/07/2021 10:11,Meter,100741,102906,2165,1457,13.266,3.922487131,TRUE
7597,63760,2021-07-29T06:02:54,1765533667,01/07/2021 10:11,Meter,61534,62854,1320,906,9,3.595238095,TRUE
6849,33642,2021-07-29T06:02:54,1497121213,01/07/2021 10:11,Meter,32616,33236,620,406,4.5,3.222222222,TRUE
36702,71890,2021-07-29T06:02:54,2033990334,01/07/2021 10:11,Meter,69542,70949,1407,941,9.4905,3.54113512,TRUE
37804,44001,2021-07-29T06:02:55,960247152,01/07/2021 10:11,Meter,42933,43578,645,423,6.048,2.49787415,TRUE
37117,91034,2021-07-29T06:02:55,691810739,01/07/2021 10:11,Meter,88092,89818,1726,1216,11.07,3.92308685,TRUE
23482,64647,2021-07-29T06:02:55,1765551698,01/07/2021 10:11,Meter,62764,63920,1156,727,8.384,3.096885224,TRUE
29025,54406,2021-07-29T06:02:55,960248140,01/07/2021 10:11,Meter,52479,53646,1167,760,8.262,3.285264723,TRUE
38888,39987,2021-07-29T06:02:56,1228680354,01/07/2021 10:11,Meter,38533,39401,868,586,5.04,4.152494331,TRUE
23877,34612,2021-07-29T06:02:56,1228671709,01/07/2021 10:11,Meter,33314,34073,759,539,4.4145,4.360629743,TRUE
85036,58427,2021-07-29T06:02:56,1228842880,01/07/2021 10:11,Meter,55179,57172,1993,1255,12.965,3.457109801,TRUE
24162,40641,2021-07-29T06:02:56,691809998,01/07/2021 10:11,Meter,39195,40036,841,605,4.7088,4.58867288,TRUE
27373,78332,2021-07-29T06:02:57,960241965,01/07/2021 10:11,Meter,75566,77187,1621,1145,9.6255,4.248387839,TRUE
22616,40105,2021-07-29T06:02:57,1497116767,01/07/2021 10:11,Meter,38633,39490,857,615,5.003,4.390223009,TRUE
40105,46906,2021-07-29T06:02:59,691807034,01/07/2021 10:11,Meter,45316,46272,956,634,6.075,3.727219283,TRUE
63040,88134,2021-07-29T06:03:00,960351880,01/07/2021 10:11,Meter,84901,86795,1894,1339,14.175,3.373645755,TRUE
37636,75441,2021-07-29T06:03:00,960241224,01/07/2021 10:11,Meter,72498,74218,1720,1223,13.338,3.274746696,TRUE
37637,51194,2021-07-29T06:03:00,960241471,01/07/2021 10:11,Meter,49355,50443,1088,751,7.695,3.485565766,TRUE
27397,80489,2021-07-29T06:03:01,423374326,01/07/2021 10:11,Meter,77686,79360,1674,1129,12.312,3.274969832,TRUE
25093,31733,2021-07-29T06:03:01,2033991322,01/07/2021 10:11,Meter,30680,31323,643,410,4.658,3.143593204,TRUE
23839,27568,2021-07-29T06:03:01,1765555156,01/07/2021 10:11,Meter,26771,27223,452,345,4.536,2.716364324,TRUE
23494,46738,2021-07-29T06:03:01,960256044,01/07/2021 10:11,Meter,45379,46164,785,574,5.445,3.764921947,TRUE
83569,94343,2021-07-29T06:03:02,1228965886,01/07/2021 10:11,Meter,89419,92271,2852,2072,14.58,5.075445816,TRUE
21836,38831,2021-07-29T06:03:02,423379019,01/07/2021 10:11,Meter,37707,38369,662,462,4.59,3.594771242,TRUE
26030,43296,2021-07-29T06:03:02,1228685788,01/07/2021 10:11,Meter,42122,42829,707,467,5.292,3.151657488,TRUE
34767,49245,2021-07-29T06:03:02,1765556391,01/07/2021 10:11,Meter,47471,48561,1090,684,6.048,4.039115646,TRUE
30507,72215,2021-07-29T06:03:03,691814691,01/07/2021 10:11,Meter,66904,71321,4417,894,10.62,3.00645682,TRUE
23229,80138,2021-07-29T06:03:03,1765555650,01/07/2021 10:11,Meter,77674,79141,1467,997,10.836,3.286004324,TRUE
20142,40414,2021-07-29T06:03:04,691818149,01/07/2021 10:11,Meter,39045,39853,808,561,5.04,3.975340136,TRUE
29035,81263,2021-07-29T06:03:04,1228688752,01/07/2021 10:11,Meter,78705,80193,1488,1070,9.9,3.86002886,TRUE
24794,32812,2021-07-29T06:03:04,154943100,01/07/2021 10:11,Meter,31708,32373,665,439,4.284,3.659797252,TRUE
14834,71484,2021-07-29T06:03:04,691814444,01/07/2021 10:11,Meter,69311,70592,1281,892,8.424,3.781712115,TRUE
26368,62124,2021-07-29T06:03:05,2033992063,01/07/2021 10:11,Meter,60376,61378,1002,746,7.1145,3.744867122,TRUE
29134,71371,2021-07-29T06:03:05,2034250919,01/07/2021 10:11,Meter,68778,70334,1556,1037,9.653,3.836705095,TRUE
26553,54085,2021-07-29T06:03:05,1228689740,01/07/2021 10:11,Meter,52387,53419,1032,666,7.0632,3.367554973,TRUE
27636,58132,2021-07-29T06:03:06,423378278,01/07/2021 10:11,Meter,56423,57414,991,718,6.048,4.239890401,TRUE
23662,35799,2021-07-29T06:03:06,691813209,01/07/2021 10:11,Meter,34579,35298,719,501,4.455,4.016354016,TRUE
20000,101100,2021-07-29T06:03:06,154942853,01/07/2021 10:11,Meter,98143,99872,1729,1228,11.88,3.691678692,TRUE
27443,47643,2021-07-29T06:03:06,423381736,01/07/2021 10:12,Meter,45797,46900,1103,743,6.93,3.829107401,TRUE
20840,43974,2021-07-29T06:03:07,154947052,01/07/2021 10:12,Meter,42589,43411,822,563,5.4,3.723544974,TRUE
24965,66518,2021-07-29T06:03:07,423372597,01/07/2021 10:12,Meter,64465,65656,1191,862,9.936,3.098401196,TRUE
26180,49544,2021-07-29T06:03:07,1497125165,01/07/2021 10:12,Meter,48121,49032,911,512,6.21,2.944559466,TRUE
36309,154921,2021-07-29T06:03:08,1765559849,01/07/2021 10:12,Meter,149669,152802,3133,2119,21.19,3.571428571,TRUE
26004,47252,2021-07-29T06:03:08,423376549,01/07/2021 10:12,Meter,45658,46628,970,624,5.427,4.106451868,TRUE
25913,41385,2021-07-29T06:03:08,1497120966,01/07/2021 10:12,Meter,40133,40898,765,487,5.2974,3.283281826,TRUE
36369,75620,2021-07-29T06:03:09,691816173,01/07/2021 10:12,Meter,72851,74549,1698,1071,11.178,3.421900161,TRUE
36370,39826,2021-07-29T06:03:09,2033982430,01/07/2021 10:12,Meter,38491,39302,811,524,6.18,3.028201572,TRUE
36371,115258,2021-07-29T06:03:09,1765547746,01/07/2021 10:12,Meter,111264,113686,2422,1572,16.775,3.346817117,TRUE
36372,39968,2021-07-29T06:03:09,154937172,01/07/2021 10:12,Meter,38655,39453,798,515,5.2974,3.472053676,TRUE
36373,43042,2021-07-29T06:03:10,154944582,01/07/2021 10:12,Meter,41725,42518,793,524,5.2974,3.532730342,TRUE
55883,56643,2021-07-29T06:03:10,1497427987,01/07/2021 10:12,Meter,54158,55640,1482,1003,9.396,3.812412577,TRUE
27470,45997,2021-07-29T06:03:10,1765556144,01/07/2021 10:12,Meter,44338,45328,990,669,6.769,3.529746956,TRUE
36427,90834,2021-07-29T06:03:10,960246411,01/07/2021 10:12,Meter,87755,89554,1799,1280,10.773,4.243412765,TRUE
27457,62887,2021-07-29T06:03:10,1228741610,01/07/2021 10:12,Meter,60747,62060,1313,827,8.3835,3.523076792,TRUE
26500,56590,2021-07-29T06:03:11,691815926,01/07/2021 10:12,Meter,55121,55882,761,708,8.2404,3.06850569,TRUE
35851,14814,2021-07-29T06:03:11,960252833,01/07/2021 10:12,Meter,14401,14650,249,164,2.475,2.366522367,TRUE
23276,69063,2021-07-29T06:03:11,1228684800,01/07/2021 10:12,Meter,67208,68315,1107,748,9.576,2.789712376,TRUE
36329,61457,2021-07-29T06:03:12,1765548240,01/07/2021 10:12,Meter,59546,60719,1173,738,8.1,3.253968254,TRUE
36342,57488,2021-07-29T06:03:12,960253821,01/07/2021 10:12,Meter,55789,56818,1029,670,7.3575,3.252269307,TRUE
26562,51166,2021-07-29T06:03:12,691812221,01/07/2021 10:12,Meter,49644,50531,887,635,5.67,3.999748047,TRUE
36357,64225,2021-07-29T06:03:12,423383959,01/07/2021 10:12,Meter,62167,63383,1216,842,8.064,3.729095805,TRUE
26151,43775,2021-07-29T06:03:13,691808516,01/07/2021 10:12,Meter,42416,43232,816,543,5.292,3.664561063,TRUE
27454,50664,2021-07-29T06:03:13,1228683565,01/07/2021 10:12,Meter,48894,50013,1119,651,8.064,2.883184524,TRUE
35684,12522,2021-07-29T06:03:13,2033985888,01/07/2021 10:12,Meter,11068,11928,860,594,5.3865,3.938417472,TRUE
21171,31426,2021-07-29T06:03:13,2033994533,01/07/2021 10:12,Meter,29995,30829,834,597,4.59,4.64519141,TRUE
25473,87590,2021-07-29T06:03:14,2033986135,01/07/2021 10:12,Meter,84983,86507,1524,1083,9.45,4.092970522,TRUE
26581,85080,2021-07-29T06:03:14,423370127,01/07/2021 10:12,Meter,82122,83905,1783,1175,13.266,3.163296074,TRUE
24369,66539,2021-07-29T06:03:14,960249869,01/07/2021 10:12,Meter,64454,65703,1249,836,8.159,3.659412043,TRUE
36351,88195,2021-07-29T06:03:14,960243694,01/07/2021 10:12,Meter,85207,87019,1812,1176,12.618,3.328578222,TRUE
24693,67173,2021-07-29T06:03:15,691807775,01/07/2021 10:12,Meter,65220,66372,1152,801,7.452,3.838854382,TRUE
36350,79350,2021-07-29T06:03:15,1497124918,01/07/2021 10:12,Meter,76753,78295,1542,1055,10.08,3.737953515,TRUE
36365,29567,2021-07-29T06:03:16,2033993051,01/07/2021 10:12,Meter,28515,29159,644,408,4.779,3.049053897,TRUE
25988,70314,2021-07-29T06:03:16,154946311,01/07/2021 10:12,Meter,68253,69477,1224,837,7.425,4.025974026,TRUE
36363,56190,2021-07-29T06:03:16,1228688258,01/07/2021 10:12,Meter,54255,55433,1178,757,6.9345,3.898725833,TRUE
23423,20672,2021-07-29T06:03:16,1497124424,01/07/2021 10:12,Meter,20074,20417,343,255,2.673,3.40708674,TRUE
39887,106898,2021-07-29T06:03:17,154948287,01/07/2021 10:12,Meter,103587,105576,1989,1322,12.3606,3.819740604,TRUE
40107,18488,2021-07-29T06:03:17,1228686282,01/07/2021 10:12,Meter,17829,18223,394,265,2.565,3.689780006,TRUE
40644,51109,2021-07-29T06:03:17,423375808,01/07/2021 10:12,Meter,49315,50400,1085,709,6.93,3.653885797,TRUE
40687,44269,2021-07-29T06:03:17,154941371,01/07/2021 10:12,Meter,42746,43678,932,591,6.318,3.340795007,TRUE
40698,50632,2021-07-29T06:03:18,691820125,01/07/2021 10:12,Meter,48919,49979,1060,653,7.956,2.931300725,TRUE
40898,49992,2021-07-29T06:03:18,423383218,01/07/2021 10:12,Meter,48417,49455,1038,537,7.488,2.561240842,TRUE
40699,50715,2021-07-29T06:03:18,154944335,01/07/2021 10:12,Meter,49206,50117,911,598,6.552,3.259637188,TRUE
40892,49198,2021-07-29T06:03:18,423375067,01/07/2021 10:12,Meter,47576,48573,997,625,7.056,3.163467768,TRUE
40894,28723,2021-07-29T06:03:19,960246905,01/07/2021 10:12,Meter,27643,28296,653,427,4.032,3.782242063,TRUE
40765,21864,2021-07-29T06:03:19,1765541818,01/07/2021 10:12,Meter,21041,21533,492,331,3.276,3.60849468,TRUE
37094,86584,2021-07-29T06:03:19,691806540,01/07/2021 10:12,Meter,84091,85600,1509,984,10.584,3.320375769,TRUE
36696,42286,2021-07-29T06:03:20,1765552686,01/07/2021 10:12,Meter,41054,41782,728,504,5.04,3.571428571,TRUE
39173,76738,2021-07-29T06:03:20,1765551451,01/07/2021 10:12,Meter,73982,75653,1671,1085,11.2455,3.445822774,TRUE
38813,74139,2021-07-29T06:03:20,423364446,01/07/2021 10:12,Meter,71865,73241,1376,898,11.016,2.911349725,TRUE
73790,78702,2021-07-29T06:03:20,154936184,01/07/2021 10:12,Meter,75419,77405,1986,1297,12.96,3.574184303,TRUE
39427,50397,2021-07-29T06:03:21,1765547005,01/07/2021 10:12,Meter,48233,49501,1268,896,7.9605,4.019847999,TRUE
41262,83128,2021-07-29T06:03:21,423377290,01/07/2021 10:12,Meter,80557,82113,1556,1015,10.0062,3.622753893,TRUE
38433,74365,2021-07-29T06:03:21,423372350,01/07/2021 10:12,Meter,72347,73625,1278,740,11.088,2.383529169,TRUE
25869,65994,2021-07-29T06:03:21,691817655,01/07/2021 10:12,Meter,63360,64984,1624,1010,11.232,3.211487586,TRUE
41097,76196,2021-07-29T06:03:22,691815679,01/07/2021 10:12,Meter,73778,75252,1474,944,9,3.746031746,TRUE
41094,45950,2021-07-29T06:03:22,1765557132,01/07/2021 10:12,Meter,44200,45252,1052,698,6.3,3.9569161,TRUE
14543,80146,2021-07-29T06:03:22,960244682,01/07/2021 10:12,Meter,77622,79137,1515,1009,10.068,3.579232647,TRUE
41093,62066,2021-07-29T06:03:22,2033982924,01/07/2021 10:12,Meter,60823,61295,472,771,9.45,2.9138322,TRUE
41092,99725,2021-07-29T06:03:23,423377043,01/07/2021 10:12,Meter,96126,98313,2187,1412,13.3515,3.776996699,TRUE
41091,51025,2021-07-29T06:03:23,1497118990,01/07/2021 10:12,Meter,49274,50354,1080,671,8.1,2.958553792,TRUE
41085,36642,2021-07-29T06:03:25,1765547252,01/07/2021 10:12,Meter,35385,36148,763,494,4.95,3.564213564,TRUE
41023,68976,2021-07-29T06:03:25,1228681342,01/07/2021 10:12,Meter,66814,68128,1314,848,8.1,3.738977072,TRUE
40912,71249,2021-07-29T06:03:25,1497112815,01/07/2021 10:12,Meter,69303,70474,1171,775,9.234,2.997462793,TRUE
40910,53552,2021-07-29T06:03:26,960250116,01/07/2021 10:12,Meter,51648,52799,1151,753,10.0035,2.688344794,TRUE
38313,78088,2021-07-29T06:03:26,1228691716,01/07/2021 10:12,Meter,75608,77075,1467,1013,9.4905,3.812082759,TRUE
39177,48479,2021-07-29T06:03:26,1765548487,01/07/2021 10:12,Meter,46474,47670,1196,809,7.695,3.754757264,TRUE
37854,37442,2021-07-29T06:03:26,1228683071,01/07/2021 10:12,Meter,35962,36844,882,598,5.544,3.852298495,TRUE
39381,41292,2021-07-29T06:03:28,960244188,01/07/2021 10:12,Meter,40004,40775,771,517,5.3865,3.427881874,TRUE
39480,77920,2021-07-29T06:03:28,1228685541,01/07/2021 10:12,Meter,74798,76633,1835,1287,11.907,3.860274268,TRUE
40903,70436,2021-07-29T06:03:29,1497121460,01/07/2021 10:12,Meter,68237,69557,1320,879,9.072,3.460411943,TRUE
40116,42236,2021-07-29T06:03:29,960246164,01/07/2021 10:12,Meter,40813,41633,820,603,5.85,3.681318681,TRUE
40115,49283,2021-07-29T06:03:29,2033987864,01/07/2021 10:12,Meter,47490,48590,1100,693,8.1,3.055555556,TRUE
40114,71768,2021-07-29T06:03:29,960247646,01/07/2021 10:12,Meter,69410,70847,1437,921,8.1,4.060846561,TRUE
40110,41840,2021-07-29T06:03:30,2033987617,01/07/2021 10:12,Meter,40714,41370,656,470,4.95,3.391053391,TRUE
40066,35959,2021-07-29T06:03:30,1765551204,01/07/2021 10:12,Meter,34751,35457,706,502,4.05,4.42680776,TRUE
40000,28476,2021-07-29T06:03:30,2033986629,01/07/2021 10:12,Meter,27306,27979,673,497,4.788,3.707184628,TRUE
40908,47405,2021-07-29T06:03:30,1497108122,01/07/2021 10:12,Meter,46009,46826,817,579,5.544,3.729901051,TRUE
39395,64537,2021-07-29T06:03:31,1497106146,01/07/2021 10:12,Meter,62341,63681,1340,856,9.8685,3.097879979,TRUE
38922,59538,2021-07-29T06:03:32,1765550463,01/07/2021 10:12,Meter,57534,58706,1172,832,7.695,3.861505616,TRUE
18830,73885,2021-07-29T06:03:32,423377784,01/07/2021 10:12,Meter,71801,73011,1210,874,9.18,3.400248988,TRUE
17620,69667,2021-07-29T06:03:32,1765554909,01/07/2021 10:12,Meter,67359,68720,1361,947,9.72,3.479570841,TRUE
39223,164046,2021-07-29T06:03:33,960243200,01/07/2021 10:12,Meter,159092,162081,2989,1965,17.658,3.974321635,TRUE
38924,64496,2021-07-29T06:03:33,154935937,01/07/2021 10:12,Meter,62190,63625,1435,871,9.324,3.336244408,TRUE
45946,91440,2021-07-29T06:03:33,1765560837,01/07/2021 10:12,Meter,88420,90184,1764,1256,11.475,3.909119203,TRUE
38877,53555,2021-07-29T06:03:33,1497122448,01/07/2021 10:12,Meter,51768,52849,1081,706,6.21,4.060271452,TRUE
25302,59714,2021-07-29T06:03:34,154929762,01/07/2021 10:12,Meter,57771,58920,1149,794,7.3575,3.854181836,TRUE
41971,29909,2021-07-29T06:03:34,154935196,01/07/2021 10:12,Meter,28881,29499,618,410,4.4145,3.316991085,TRUE
39771,131884,2021-07-29T06:03:34,2033977490,01/07/2021 10:12,Meter,127190,129938,2748,1946,17.856,3.892249104,TRUE
81874,60020,2021-07-29T06:03:34,960372381,01/07/2021 10:12,Meter,57182,58821,1639,1199,9.608,4.456851433,TRUE
16488,58787,2021-07-29T06:03:35,960249375,01/07/2021 10:12,Meter,57005,58051,1046,736,6.48,4.05643739,TRUE
38449,34926,2021-07-29T06:03:35,1228677143,01/07/2021 10:12,Meter,33890,34514,624,412,5.94,2.477152477,TRUE
42846,68005,2021-07-29T06:03:35,423377537,01/07/2021 10:12,Meter,66474,67006,532,999,8.775,4.065934066,TRUE
43028,68213,2021-07-29T06:03:35,154940877,01/07/2021 10:12,Meter,65972,67332,1360,881,9.072,3.468285462,TRUE
43033,47791,2021-07-29T06:03:36,2033976996,01/07/2021 10:12,Meter,45957,47077,1120,714,7.056,3.613945578,TRUE
39944,49100,2021-07-29T06:03:36,423379266,01/07/2021 10:12,Meter,47595,48503,908,597,5.886,3.622396971,TRUE
27503,38612,2021-07-29T06:03:38,691817408,01/07/2021 10:13,Meter,37263,38084,821,528,5.796,3.253475303,TRUE
20823,58999,2021-07-29T06:03:39,423370868,01/07/2021 10:13,Meter,57277,58311,1034,688,7.425,3.309283309,TRUE
39606,39084,2021-07-29T06:03:39,1765549228,01/07/2021 10:13,Meter,37682,38515,833,569,5.796,3.50611259,TRUE
57527,59114,2021-07-29T06:03:39,691810245,01/07/2021 10:13,Meter,56284,58015,1731,1099,10.8,3.634259259,TRUE
43204,75878,2021-07-29T06:03:39,154929515,01/07/2021 10:13,Meter,73078,74781,1703,1097,11.178,3.5049715,TRUE
43261,33520,2021-07-29T06:03:40,691809257,01/07/2021 10:13,Meter,32278,33036,758,484,5.589,3.092809856,TRUE
4614,48850,2021-07-29T06:03:40,154937419,01/07/2021 10:13,Meter,47153,48175,1022,675,5.922,4.070777247,TRUE
43301,53587,2021-07-29T06:03:40,960236037,01/07/2021 10:13,Meter,51893,52887,994,700,7.56,3.306878307,TRUE
25920,29508,2021-07-29T06:03:40,960248634,01/07/2021 10:13,Meter,28631,29160,529,348,3.713,3.347312531,TRUE
26183,49061,2021-07-29T06:03:41,1228688011,01/07/2021 10:13,Meter,47358,48380,1022,681,6.633,3.666731279,TRUE
42383,48666,2021-07-29T06:03:41,1765552192,01/07/2021 10:13,Meter,47020,48006,986,660,8.82,2.67249757,TRUE
36390,33411,2021-07-29T06:03:41,1228678625,01/07/2021 10:13,Meter,32390,33005,615,406,4.68,3.098290598,TRUE
43074,94238,2021-07-29T06:03:41,1765548734,01/07/2021 10:13,Meter,91214,93029,1815,1209,12.6,3.426870748,TRUE
35056,39132,2021-07-29T06:03:42,1228689987,01/07/2021 10:13,Meter,37784,38594,810,538,4.32,4.447751323,TRUE
24867,46931,2021-07-29T06:03:42,423383465,01/07/2021 10:13,Meter,45366,46312,946,619,6.318,3.499072944,TRUE
36617,75312,2021-07-29T06:03:42,2033995274,01/07/2021 10:13,Meter,72833,74352,1519,960,9.828,3.488574917,TRUE
88888,10711,2021-07-29T06:03:42,1765664577,01/07/2021 10:13,Meter,10108,10473,365,238,3.5316,2.406841092,TRUE
43679,57007,2021-07-29T06:03:43,154928280,01/07/2021 10:13,Meter,54967,56207,1240,800,8.064,3.5430839,TRUE
43888,69472,2021-07-29T06:03:43,1228670721,01/07/2021 10:13,Meter,67255,68608,1353,864,9.315,3.3126294,TRUE
43745,43880,2021-07-29T06:03:43,1497105899,01/07/2021 10:13,Meter,42358,43252,894,628,8.064,2.781320862,TRUE
44117,59186,2021-07-29T06:03:43,154929021,01/07/2021 10:13,Meter,57239,58427,1188,759,7.56,3.585600907,TRUE
44198,183162,2021-07-29T06:03:44,960235543,01/07/2021 10:13,Meter,176845,180605,3760,2557,25.4925,3.582286107,TRUE
44387,28271,2021-07-29T06:03:44,691799871,01/07/2021 10:13,Meter,27295,27885,590,386,3.8475,3.583031653,TRUE
44460,34499,2021-07-29T06:03:44,2033986382,01/07/2021 10:13,Meter,33270,34012,742,487,5.796,3.000838016,TRUE
66695,48699,2021-07-29T06:03:44,1765676433,01/07/2021 10:13,Meter,46376,47785,1409,914,8.694,3.754641953,TRUE
24988,99719,2021-07-29T06:03:45,1765542806,01/07/2021 10:13,Meter,96316,98352,2036,1367,13.365,3.652931431,TRUE
29085,88702,2021-07-29T06:03:45,1765543794,01/07/2021 10:13,Meter,85556,87420,1864,1282,11.1834,4.094078213,TRUE
36605,32695,2021-07-29T06:03:45,423379760,01/07/2021 10:13,Meter,31800,32333,533,362,4.95,2.611832612,TRUE
43492,31649,2021-07-29T06:03:45,2033977243,01/07/2021 10:13,Meter,30463,31181,718,468,4.8735,3.429626698,TRUE
43695,58927,2021-07-29T06:03:46,1765562566,01/07/2021 10:13,Meter,56998,58147,1149,780,6.831,4.078047556,TRUE
23198,55099,2021-07-29T06:03:46,2034026396,05/07/2021 10:10,Meter,53550,54488,938,611,10.5948,2.059635724,TRUE
27510,77149,2021-07-29T06:03:46,423413846,01/07/2021 10:13,Meter,74668,76126,1458,1023,10.26,3.560985798,TRUE
44059,81799,2021-07-29T06:03:46,154930997,01/07/2021 10:13,Meter,78938,80547,1609,1252,11.25,3.974603175,TRUE
44772,75779,2021-07-29T06:03:47,1497108616,01/07/2021 10:13,Meter,73150,74746,1596,1033,11.1834,3.298894535,TRUE
44649,44250,2021-07-29T06:03:49,1228672450,01/07/2021 10:13,Meter,42709,43635,926,615,5.616,3.911019536,TRUE
44992,30114,2021-07-29T06:03:49,691795672,01/07/2021 10:13,Meter,29135,29720,585,394,4.3605,3.227021803,TRUE
45133,64393,2021-07-29T06:03:49,960230109,01/07/2021 10:13,Meter,62202,63503,1301,890,9.315,3.412315007,TRUE
45137,42011,2021-07-29T06:03:50,2033978725,01/07/2021 10:13,Meter,40397,41387,990,624,7.308,3.04949566,TRUE
42853,45266,2021-07-29T06:03:50,960235296,01/07/2021 10:13,Meter,43779,44687,908,579,6.48,3.191137566,TRUE
43346,63795,2021-07-29T06:03:50,154930503,01/07/2021 10:13,Meter,61722,62979,1257,816,6.588,4.423627374,TRUE
40101,80763,2021-07-29T06:03:50,154951745,01/07/2021 10:13,Meter,78382,79825,1443,938,9,3.722222222,TRUE
36703,56789,2021-07-29T06:03:51,1228679860,01/07/2021 10:13,Meter,55078,56094,1016,695,7.056,3.517776158,TRUE
46711,42044,2021-07-29T06:03:51,154930750,01/07/2021 10:13,Meter,40598,41448,850,596,5.13,4.149262044,TRUE
5584,61931,2021-07-29T06:03:51,691812468,01/07/2021 10:13,Meter,59880,61119,1239,812,10.26,2.826510721,TRUE
45947,74126,2021-07-29T06:03:51,2033990581,01/07/2021 10:13,Meter,71588,73114,1526,1012,9.675,3.735695829,TRUE
46021,36505,2021-07-29T06:03:52,1228686529,01/07/2021 10:13,Meter,35212,35989,777,516,6.156,2.993595099,TRUE
46025,28779,2021-07-29T06:03:52,960231591,01/07/2021 10:13,Meter,27708,28355,647,424,4.536,3.338372386,TRUE
75678,18581,2021-07-29T06:03:52,1765537619,01/07/2021 10:13,Meter,17787,18277,490,304,2.745,3.9552433,TRUE
46106,35171,2021-07-29T06:03:52,423384700,01/07/2021 10:13,Meter,33974,34696,722,475,4.536,3.739921895,TRUE
46167,30252,2021-07-29T06:03:53,1228694433,01/07/2021 10:13,Meter,29047,29776,729,476,5.382,3.158677072,TRUE
46168,28403,2021-07-29T06:03:53,1765587019,01/07/2021 10:13,Meter,27335,27987,652,416,4.68,3.174603175,TRUE
46094,40980,2021-07-29T06:03:53,960228380,01/07/2021 10:13,Meter,39402,40349,947,631,6.552,3.439516832,TRUE
45626,288413,2021-07-29T06:03:53,1497114297,01/07/2021 10:13,Meter,276164,283408,7244,5005,46.8,3.819444444,TRUE
3878,70152,2021-07-29T06:03:54,423411376,01/07/2021 10:13,Meter,68813,69632,819,520,4.968,3.73821026,TRUE
46282,229652,2021-07-29T06:03:54,154934455,01/07/2021 10:13,Meter,222060,226629,4569,3023,29.646,3.641782558,TRUE
46338,34644,2021-07-29T06:03:54,691809751,01/07/2021 10:13,Meter,33252,34099,847,545,6.9255,2.810524253,TRUE
46354,28182,2021-07-29T06:03:54,1228665287,01/07/2021 10:13,Meter,27326,27843,517,339,3.528,3.431729835,TRUE
46519,44541,2021-07-29T06:03:55,1765645311,01/07/2021 10:13,Meter,42612,43776,1164,765,6.669,4.096780413,TRUE
46665,92180,2021-07-29T06:03:55,1765533914,01/07/2021 10:13,Meter,88866,90840,1974,1340,12.078,3.962340028,TRUE
40099,57752,2021-07-29T06:03:55,154928774,01/07/2021 10:13,Meter,56459,57277,818,475,11.16,1.520097286,TRUE
29049,76964,2021-07-29T06:03:55,1765613448,01/07/2021 10:13,Meter,74545,75974,1429,990,8.262,4.279489574,TRUE
47023,39034,2021-07-29T06:03:56,2033980701,01/07/2021 10:13,Meter,37447,38401,954,633,7.128,3.171596922,TRUE
47040,29358,2021-07-29T06:03:56,1228660594,01/07/2021 10:13,Meter,28189,28914,725,444,4.68,3.388278388,TRUE
47047,79355,2021-07-29T06:03:56,1765545770,01/07/2021 10:13,Meter,76470,78180,1710,1175,10.8,3.885582011,TRUE
47085,43112,2021-07-29T06:03:56,2033992557,01/07/2021 10:13,Meter,41790,42584,794,528,4.86,3.880070547,TRUE
46041,60276,2021-07-29T06:03:57,423355554,01/07/2021 10:13,Meter,57915,59329,1414,947,9.234,3.662706148,TRUE
45937,34931,2021-07-29T06:03:57,691810492,01/07/2021 10:13,Meter,33587,34391,804,540,5.2974,3.640599971,TRUE
46560,31111,2021-07-29T06:03:57,691801600,01/07/2021 10:13,Meter,30043,30694,651,417,5.04,2.954931973,TRUE
46237,53747,2021-07-29T06:03:58,960229862,01/07/2021 10:13,Meter,51759,52981,1222,766,8.4645,3.231985688,TRUE
43716,93556,2021-07-29T06:03:58,691799624,01/07/2021 10:13,Meter,90059,92190,2131,1366,13.5,3.613756614,TRUE
47251,64803,2021-07-29T06:03:58,1765554168,01/07/2021 10:13,Meter,62603,63965,1362,838,10.8,2.771164021,TRUE
45742,48496,2021-07-29T06:03:58,154924822,01/07/2021 10:13,Meter,46627,47760,1133,736,6.804,3.863273705,TRUE
62773,38796,2021-07-29T06:03:59,960236778,01/07/2021 10:13,Meter,37072,38116,1044,680,7.047,3.446248657,TRUE
45613,43753,2021-07-29T06:03:59,691801847,01/07/2021 10:13,Meter,42284,43167,883,586,7.182,2.91403111,TRUE
45680,17487,2021-07-29T06:03:59,2033969092,01/07/2021 10:13,Meter,16941,17261,320,226,2.52,3.202947846,TRUE
45711,80828,2021-07-29T06:03:59,691800118,01/07/2021 10:13,Meter,78164,79761,1597,1067,9.72,3.920487948,TRUE
45718,17006,2021-07-29T06:04:00,423371609,01/07/2021 10:13,Meter,16399,16769,370,237,2.268,3.732048375,TRUE
78848,48220,2021-07-29T06:04:00,155213318,01/07/2021 10:13,Meter,45875,46968,1093,1252,9.72,4.600235156,TRUE
45802,44357,2021-07-29T06:04:00,1497108863,01/07/2021 10:13,Meter,42663,43690,1027,667,7.9515,2.995840857,TRUE
45806,45998,2021-07-29T06:04:00,154932479,01/07/2021 10:13,Meter,44661,45464,803,534,6.156,3.098022835,TRUE
86041,48551,2021-07-29T06:04:01,2034305753,01/07/2021 10:13,Meter,45993,47520,1527,1031,8.7435,4.211291653,TRUE
45817,23812,2021-07-29T06:04:01,1228674920,01/07/2021 10:13,Meter,23075,23520,445,292,3.024,3.448601663,TRUE
45845,21355,2021-07-29T06:04:01,2033976502,01/07/2021 10:13,Meter,20553,21040,487,315,4.032,2.790178571,TRUE
81733,38405,2021-07-29T06:04:02,1765835995,01/07/2021 10:13,Meter,36252,37529,1277,876,9.072,3.448601663,TRUE
45921,57461,2021-07-29T06:04:02,691939179,01/07/2021 10:13,Meter,55507,56703,1196,758,6.156,4.397567994,TRUE
45932,35259,2021-07-29T06:04:02,1228669733,01/07/2021 10:13,Meter,34050,34784,734,475,5.796,2.926895396,TRUE
45934,23103,2021-07-29T06:04:03,960238013,01/07/2021 10:13,Meter,22173,22743,570,360,5.3352,2.409870831,TRUE
75264,45756,2021-07-29T06:04:03,2034168668,01/07/2021 10:13,Meter,43810,44981,1171,775,8.235,3.361089427,TRUE
46212,80456,2021-07-29T06:04:03,1228673438,01/07/2021 10:13,Meter,77723,79372,1649,1084,10.3005,3.758486065,TRUE
20846,33049,2021-07-29T06:04:03,1497117508,01/07/2021 10:13,Meter,32218,32713,495,336,6.156,1.949317739,TRUE
35682,63622,2021-07-29T06:04:03,1497123436,01/07/2021 10:13,Meter,61682,62859,1177,763,8.91,3.058361392,TRUE
54349,106012,2021-07-29T06:04:04,1765746828,01/07/2021 10:13,Meter,102189,104458,2269,1554,13.9725,3.97208803,TRUE
69772,71370,2021-07-29T06:04:04,2033978478,01/07/2021 10:13,Meter,67877,70023,2146,1347,14.283,3.368139947,TRUE
46039,67975,2021-07-29T06:04:04,154930256,01/07/2021 10:13,Meter,65279,66936,1657,1039,11.934,3.109363403,TRUE
44017,65252,2021-07-29T06:04:05,423364693,01/07/2021 10:13,Meter,62801,64297,1496,955,9.936,3.43268346,TRUE
46206,62132,2021-07-29T06:04:07,423356542,01/07/2021 10:14,Meter,59875,61222,1347,910,9.072,3.582451499,TRUE
46201,65571,2021-07-29T06:04:07,423363952,01/07/2021 10:14,Meter,62978,64501,1523,1070,9.639,3.964548782,TRUE
44386,26485,2021-07-29T06:04:07,691799377,01/07/2021 10:14,Meter,25512,26101,589,384,3.848,3.564003564,TRUE
18389,57984,2021-07-29T06:04:08,691812962,01/07/2021 10:14,Meter,55954,57201,1247,783,7.673,3.64450485,TRUE
46244,82807,2021-07-29T06:04:08,960253574,01/07/2021 10:14,Meter,80323,81824,1501,983,10.395,3.37731052,TRUE
27333,60216,2021-07-29T06:04:08,960234802,01/07/2021 10:14,Meter,58136,59370,1234,846,8.1,3.73015873,TRUE
47888,81714,2021-07-29T06:04:09,423387911,01/07/2021 10:14,Meter,78835,80536,1701,1178,10.557,3.985168947,TRUE
48022,63087,2021-07-29T06:04:09,1228674673,01/07/2021 10:14,Meter,61147,62279,1132,808,8.424,3.425586759,TRUE
27528,59645,2021-07-29T06:04:09,960282967,01/07/2021 10:14,Meter,57520,58797,1277,848,9.418,3.215726724,TRUE
27520,55935,2021-07-29T06:04:09,691800859,01/07/2021 10:14,Meter,53487,54943,1456,992,9.9,3.578643579,TRUE
43202,48640,2021-07-29T06:04:10,1497119731,01/07/2021 10:14,Meter,46886,47945,1059,695,7.182,3.456060787,TRUE
46416,89273,2021-07-29T06:04:10,423555624,01/07/2021 10:14,Meter,86263,88091,1828,1182,11.61,3.636028055,TRUE
79091,52602,2021-07-29T06:04:10,2034096544,01/07/2021 10:14,Meter,49891,51466,1575,1136,8.424,4.816171483,TRUE
46161,25881,2021-07-29T06:04:10,1497110345,01/07/2021 10:14,Meter,25037,25548,511,333,3.591,3.311851056,TRUE
46045,66415,2021-07-29T06:04:11,1497128623,01/07/2021 10:14,Meter,64089,65493,1404,922,8.9775,3.667899909,TRUE
27595,51653,2021-07-29T06:04:11,154975704,01/07/2021 10:14,Meter,49845,50951,1106,702,7.56,3.316326531,TRUE
48169,49571,2021-07-29T06:04:11,691846801,01/07/2021 10:14,Meter,47444,48747,1303,824,10.836,2.715815008,TRUE
48655,47694,2021-07-29T06:04:11,423409400,01/07/2021 10:14,Meter,45793,46933,1140,761,7.695,3.531978093,TRUE
49107,27853,2021-07-29T06:04:12,691852235,01/07/2021 10:14,Meter,26885,27467,582,386,3.78,3.647014361,TRUE
49315,57331,2021-07-29T06:04:12,960379297,01/07/2021 10:14,Meter,55431,56562,1131,769,7.533,3.645862965,TRUE
49321,44517,2021-07-29T06:04:12,1765585784,01/07/2021 10:14,Meter,43179,43976,797,541,6.048,3.19468065,TRUE
49379,55502,2021-07-29T06:04:12,154981138,01/07/2021 10:14,Meter,54628,54795,167,707,9,2.805555556,TRUE
49381,34328,2021-07-29T06:04:13,1765587266,01/07/2021 10:14,Meter,33170,33873,703,455,4.617,3.519601473,TRUE
49923,24916,2021-07-29T06:04:13,1765586772,01/07/2021 10:14,Meter,24138,24607,469,309,3.276,3.368655154,TRUE
49924,18260,2021-07-29T06:04:13,1765588501,01/07/2021 10:14,Meter,17605,18005,400,255,3.024,3.011621315,TRUE
50230,20177,2021-07-29T06:04:17,423371115,01/07/2021 10:14,Meter,19282,19817,535,360,3.654,3.518648839,TRUE
50803,29340,2021-07-29T06:04:18,1497154805,01/07/2021 10:14,Meter,28338,28949,611,391,4.617,3.02453665,TRUE
26501,57597,2021-07-29T06:04:18,154973728,01/07/2021 10:14,Meter,55406,56726,1320,871,8.91,3.491261825,TRUE
51771,21749,2021-07-29T06:04:18,691847295,01/07/2021 10:14,Meter,21062,21477,415,272,3.015,3.221985312,TRUE
76233,34101,2021-07-29T06:04:19,1765588995,01/07/2021 10:14,Meter,32508,33464,956,637,6.624,3.434480676,TRUE
90027,27228,2021-07-29T06:04:19,692121712,01/07/2021 10:14,Meter,25590,26542,952,686,6.525,3.754789272,TRUE
51799,22475,2021-07-29T06:04:19,423475102,01/07/2021 10:14,Meter,21619,22135,516,340,4.617,2.63003187,TRUE
49947,75625,2021-07-29T06:04:19,1497096266,01/07/2021 10:14,Meter,72894,74557,1663,1068,11.178,3.412315007,TRUE
78721,21911,2021-07-29T06:04:20,960374357,01/07/2021 10:14,Meter,20851,21498,647,413,3.843,3.838147281,TRUE
52023,21621,2021-07-29T06:04:20,691791226,01/07/2021 10:14,Meter,20721,21269,548,352,3.402,3.695305283,TRUE
49065,93323,2021-07-29T06:04:20,691802341,01/07/2021 10:14,Meter,90219,92064,1845,1259,11.232,4.003230566,TRUE
50898,245184,2021-07-29T06:04:21,1228674426,01/07/2021 10:14,Meter,235745,241444,5699,3740,34.1388,3.912598819,TRUE
50396,95979,2021-07-29T06:04:21,154922846,01/07/2021 10:14,Meter,92716,94664,1948,1315,12.096,3.882629441,TRUE
50653,55992,2021-07-29T06:04:21,1765544041,01/07/2021 10:14,Meter,54233,55287,1054,705,7.236,3.479625681,TRUE
52579,35051,2021-07-29T06:04:23,1228745809,01/07/2021 10:14,Meter,33753,34543,790,508,5.8995,3.075321153,TRUE
52090,63896,2021-07-29T06:04:23,1228693939,01/07/2021 10:14,Meter,61732,62986,1254,910,9.882,3.288807934,TRUE
51718,56975,2021-07-29T06:04:26,2034023926,01/07/2021 10:14,Meter,54485,56015,1530,960,9.828,3.488574917,TRUE
51615,170327,2021-07-29T06:04:26,1765588254,01/07/2021 10:14,Meter,164493,168062,3569,2265,22.41,3.609676802,TRUE
20941,54498,2021-07-29T06:04:26,1228679613,01/07/2021 10:14,Meter,53078,53881,803,617,8.1,2.720458554,TRUE
85633,35936,2021-07-29T06:04:27,1765886877,01/07/2021 10:14,Meter,33626,35048,1422,888,7.875,4.027210884,TRUE
90194,47670,2021-07-29T06:04:27,1228861899,01/07/2021 10:14,Meter,45385,47047,1662,623,12.96,1.716820988,TRUE
50985,100598,2021-07-29T06:04:27,1765532679,01/07/2021 10:14,Meter,97120,99241,2121,1357,14.04,3.451872202,TRUE
50696,126502,2021-07-29T06:04:28,1228661829,01/07/2021 10:14,Meter,122222,124727,2505,1775,17.442,3.634494734,TRUE
50537,113649,2021-07-29T06:04:28,423413599,01/07/2021 10:14,Meter,110359,112482,2123,1167,12.312,3.385199109,TRUE
50549,32205,2021-07-29T06:04:28,2033980207,01/07/2021 10:14,Meter,31329,31851,522,354,4.4145,2.863938644,TRUE
75436,48671,2021-07-29T06:04:28,1228670474,01/07/2021 10:14,Meter,46693,47869,1176,802,8.064,3.55194161,TRUE
50092,59473,2021-07-29T06:04:29,154922105,01/07/2021 10:14,Meter,57545,58727,1182,746,7.56,3.524187453,TRUE
52060,53199,2021-07-29T06:04:29,1228662817,01/07/2021 10:14,Meter,51580,52538,958,661,6.318,3.736489848,TRUE
52058,65581,2021-07-29T06:04:29,691808763,01/07/2021 10:14,Meter,63671,64816,1145,765,7.722,3.538128538,TRUE
50110,42440,2021-07-29T06:04:29,423412611,01/07/2021 10:14,Meter,41124,41905,781,535,5.859,3.261161095,TRUE
49949,76236,2021-07-29T06:04:30,1228716663,01/07/2021 10:14,Meter,73821,75249,1428,987,10.08,3.49702381,TRUE
49934,58153,2021-07-29T06:04:30,2033966869,01/07/2021 10:14,Meter,56010,57305,1295,848,9.045,3.348337677,TRUE
49932,79735,2021-07-29T06:04:30,960287660,01/07/2021 10:14,Meter,76777,78519,1742,1216,11.34,3.82968002,TRUE
49772,74505,2021-07-29T06:04:30,960280497,01/07/2021 10:14,Meter,72048,73477,1429,1028,12.825,2.862712336,TRUE
49765,77132,2021-07-29T06:04:31,1497153323,01/07/2021 10:14,Meter,74566,76061,1495,1071,12.096,3.162202381,TRUE
93807,38141,2021-07-29T06:04:31,155237277,01/07/2021 10:14,Meter,36507,37498,991,643,12.096,1.898502457,TRUE
52679,57736,2021-07-29T06:04:31,1228674179,01/07/2021 10:14,Meter,55726,56948,1222,788,7.6545,3.676642125,TRUE
50374,103659,2021-07-29T06:04:31,1228692457,01/07/2021 10:14,Meter,98336,102298,3962,1361,13.041,3.727255798,TRUE
47254,127487,2021-07-29T06:04:32,1765564048,01/07/2021 10:14,Meter,122780,125631,2851,1856,19.8,3.347763348,TRUE
47255,64546,2021-07-29T06:04:32,154919141,01/07/2021 10:14,Meter,62290,63618,1328,928,8.1,4.091710758,TRUE
47193,75872,2021-07-29T06:04:32,691917196,01/07/2021 10:14,Meter,73562,75046,1484,826,12.9492,2.278133012,TRUE
47195,35096,2021-07-29T06:04:32,691790238,01/07/2021 10:14,Meter,33901,34616,715,480,4.725,3.628117914,TRUE
47196,65241,2021-07-29T06:04:32,1765657661,01/07/2021 10:14,Meter,62960,64338,1378,903,8.775,3.675213675,TRUE
69707,59502,2021-07-29T06:04:33,692151599,01/07/2021 10:14,Meter,57061,58602,1541,900,9.36,3.434065934,TRUE
47197,33828,2021-07-29T06:04:33,423380501,01/07/2021 10:14,Meter,32580,33336,756,492,4.5,3.904761905,TRUE
47234,106324,2021-07-29T06:04:33,1228685047,01/07/2021 10:14,Meter,103057,105050,1993,1274,13.5,3.37037037,TRUE
47235,102013,2021-07-29T06:04:34,960253327,01/07/2021 10:14,Meter,97964,100435,2471,1578,14.355,3.925959098,TRUE
47253,32192,2021-07-29T06:04:34,691803082,01/07/2021 10:14,Meter,30790,31650,860,542,5.175,3.740510697,TRUE
53456,52852,2021-07-29T06:04:34,154978174,01/07/2021 10:14,Meter,50860,52058,1198,794,9.648,2.939173182,TRUE
53274,85248,2021-07-29T06:04:34,423374079,01/07/2021 10:14,Meter,81927,83917,1990,1331,11.34,4.19186193,TRUE
84804,25654,2021-07-29T06:04:35,155274327,01/07/2021 10:14,Meter,24016,25008,992,646,6.7275,3.429420821,TRUE
20859,83578,2021-07-29T06:04:35,1228679119,01/07/2021 10:14,Meter,80887,82438,1551,1140,9.72,4.188712522,TRUE
53658,28630,2021-07-29T06:04:35,1497109357,01/07/2021 10:14,Meter,27564,28218,654,412,4.8735,3.019244016,TRUE
53743,77331,2021-07-29T06:04:35,1497102935,01/07/2021 10:14,Meter,74279,76120,1841,1211,11.4885,3.764634199,TRUE
53747,107008,2021-07-29T06:04:36,1765538607,01/07/2021 10:14,Meter,103760,105676,1916,1332,16.038,2.966169633,TRUE
54183,64339,2021-07-29T06:04:36,1228754454,01/07/2021 10:14,Meter,61782,63281,1499,1058,9.234,4.092020174,TRUE
54143,49418,2021-07-29T06:04:36,1228667757,01/07/2021 10:14,Meter,47641,48729,1088,689,8.208,2.997946255,TRUE
48064,31680,2021-07-29T06:04:37,691789497,01/07/2021 10:14,Meter,30377,31159,782,521,5.13,3.627123364,TRUE
44966,32357,2021-07-29T06:04:37,1497098489,01/07/2021 10:15,Meter,31038,31841,803,516,5.643,3.265740108,TRUE
54175,75856,2021-07-29T06:04:37,1765695946,01/07/2021 10:15,Meter,73505,74950,1445,906,9,3.595238095,TRUE
20574,50369,2021-07-29T06:04:38,1765536137,01/07/2021 10:15,Meter,48549,49621,1072,748,7.452,3.584847788,TRUE
52755,37931,2021-07-29T06:04:38,423407671,01/07/2021 10:15,Meter,36722,37448,726,483,5.103,3.380364491,TRUE
54347,73493,2021-07-29T06:04:38,1228673685,01/07/2021 10:15,Meter,70678,72339,1661,1154,12.361,3.334219377,TRUE
78827,125057,2021-07-29T06:04:38,423488193,01/07/2021 10:15,Meter,119600,122878,3278,2179,22.356,3.481008614,TRUE
54392,99322,2021-07-29T06:04:39,423448426,01/07/2021 10:15,Meter,95500,97737,2237,1585,12.375,4.574314574,TRUE
54396,38524,2021-07-29T06:04:39,154971999,01/07/2021 10:15,Meter,37298,38034,736,490,5.3865,3.248862898,TRUE
83352,37299,2021-07-29T06:04:40,423649237,01/07/2021 10:15,Meter,35151,36421,1270,878,8.1405,3.851992243,TRUE
54409,67375,2021-07-29T06:04:40,691883604,01/07/2021 10:15,Meter,65231,66526,1295,849,8.325,3.642213642,TRUE
54410,54917,2021-07-29T06:04:41,423410635,01/07/2021 10:15,Meter,53081,54187,1106,730,9,2.896825397,TRUE
54475,44744,2021-07-29T06:04:41,1497181234,01/07/2021 10:15,Meter,42931,44023,1092,721,8.28,3.109903382,TRUE
54476,125612,2021-07-29T06:04:41,691824077,01/07/2021 10:15,Meter,121297,123902,2605,1710,16.2,3.76984127,TRUE
54523,65659,2021-07-29T06:04:41,1497106887,01/07/2021 10:15,Meter,63086,64645,1559,1014,9,4.023809524,TRUE
54118,76057,2021-07-29T06:04:42,1228718886,01/07/2021 10:15,Meter,73367,74978,1611,1079,9.72,3.964579659,TRUE
54000,28315,2021-07-29T06:04:42,1497153570,01/07/2021 10:15,Meter,27275,27861,586,454,4.032,4.021400227,TRUE
54426,40478,2021-07-29T06:04:42,960259255,01/07/2021 10:15,Meter,38974,39859,885,619,6.143,3.598753517,TRUE
54524,98157,2021-07-29T06:04:42,2034025655,01/07/2021 10:15,Meter,94487,96628,2141,1529,11.7,4.667277167,TRUE
53767,48669,2021-07-29T06:04:43,1228666275,01/07/2021 10:15,Meter,46533,47839,1306,830,8.9775,3.301905558,TRUE
45610,23866,2021-07-29T06:04:43,154999416,01/07/2021 10:15,Meter,22929,23495,566,371,3.978,3.330819507,TRUE
54483,45698,2021-07-29T06:04:43,423387170,01/07/2021 10:15,Meter,44062,45051,989,647,6.831,3.382688165,TRUE
48400,62322,2021-07-29T06:04:43,1228723085,01/07/2021 10:15,Meter,60135,61464,1329,858,6.696,4.576292883,TRUE
20576,51126,2021-07-29T06:04:44,960229368,01/07/2021 10:15,Meter,49241,50362,1121,764,6.831,3.994395299,TRUE
23717,71878,2021-07-29T06:04:44,1765555897,01/07/2021 10:15,Meter,69557,70921,1364,957,8.64,3.955853175,TRUE
53844,92116,2021-07-29T06:04:44,423416810,01/07/2021 10:15,Meter,88341,90573,2232,1543,13.851,3.978567819,TRUE
53874,35372,2021-07-29T06:04:44,960282473,01/07/2021 10:15,Meter,34217,34917,700,455,4.536,3.582451499,TRUE
51570,43027,2021-07-29T06:04:45,1228741363,01/07/2021 10:15,Meter,41636,42478,842,549,5.4,3.630952381,TRUE
36358,25250,2021-07-29T06:04:46,1765749545,01/07/2021 10:15,Meter,24357,24901,544,349,3.672,3.394413321,TRUE
54511,134007,2021-07-29T06:04:47,1497129117,01/07/2021 10:15,Meter,126756,132287,5531,1720,20.601,2.981824738,TRUE
54576,88765,2021-07-29T06:04:47,1497113803,01/07/2021 10:15,Meter,85846,87652,1806,1113,11.34,3.505291005,TRUE
45918,31468,2021-07-29T06:04:47,423387417,01/07/2021 10:15,Meter,30225,30977,752,491,6.552,2.676391069,TRUE
60134,77059,2021-07-29T06:04:48,1497150112,01/07/2021 10:15,Meter,74030,75875,1845,1184,11.478,3.684066413,TRUE
54587,40258,2021-07-29T06:04:48,691793202,01/07/2021 10:15,Meter,38588,39605,1017,653,8.208,2.841304651,TRUE
15346,34351,2021-07-29T06:04:48,423355801,01/07/2021 10:15,Meter,33051,33828,777,523,4.5,4.150793651,TRUE
39864,47227,2021-07-29T06:04:48,691805799,01/07/2021 10:15,Meter,45751,46641,890,586,6.435,3.252303252,TRUE
24729,42608,2021-07-29T06:04:49,691814938,01/07/2021 10:15,Meter,41279,42081,802,527,5.445,3.456644366,TRUE
39426,41720,2021-07-29T06:04:49,2033986876,01/07/2021 10:15,Meter,40175,41108,933,612,7.182,3.043322592,TRUE
80925,25517,2021-07-29T06:04:49,1765673469,01/07/2021 10:15,Meter,24789,25214,425,303,4.95,2.186147186,TRUE
52729,44053,2021-07-29T06:04:49,1228718145,01/07/2021 10:15,Meter,42446,43411,965,642,6.521,3.516112778,TRUE
54091,34041,2021-07-29T06:04:50,960271358,01/07/2021 10:15,Meter,32851,33572,721,469,4.536,3.692680776,TRUE
44414,77521,2021-07-29T06:04:50,423359506,01/07/2021 10:15,Meter,75032,76536,1504,985,9.342,3.765635991,TRUE
52689,37983,2021-07-29T06:04:50,423512152,01/07/2021 10:15,Meter,36406,37371,965,612,6.21,3.519668737,TRUE
54615,60515,2021-07-29T06:04:50,2034060729,01/07/2021 10:15,Meter,57986,59519,1533,996,9.576,3.714643752,TRUE
43343,27659,2021-07-29T06:04:50,960244929,01/07/2021 10:15,Meter,26822,27327,505,332,3.024,3.92101285,TRUE
54766,27520,2021-07-29T06:04:51,691821854,01/07/2021 10:15,Meter,26487,27160,673,360,7.063,1.82035153,TRUE
54982,80094,2021-07-29T06:04:51,960311372,01/07/2021 10:15,Meter,76819,78812,1993,1282,12.42,3.686450426,TRUE
10439,50610,2021-07-29T06:04:51,960283461,01/07/2021 10:15,Meter,49221,50068,847,542,8.1,2.389770723,TRUE
43243,72286,2021-07-29T06:04:53,1228747538,01/07/2021 10:15,Meter,70015,71363,1348,923,9.072,3.633629378,TRUE
55624,16863,2021-07-29T06:04:54,960310384,01/07/2021 10:15,Meter,16236,16612,376,251,3.8475,2.329898821,TRUE
55611,38853,2021-07-29T06:04:54,1228780142,01/07/2021 10:15,Meter,37658,38384,726,469,6.156,2.720922677,TRUE
55335,38306,2021-07-29T06:04:54,154925563,01/07/2021 10:15,Meter,37062,37799,737,507,6.804,2.661249685,TRUE
55337,76060,2021-07-29T06:04:55,423361482,01/07/2021 10:15,Meter,73398,74946,1548,1114,9.828,4.048200477,TRUE
88884,46517,2021-07-29T06:04:55,1228976260,02/07/2021 10:10,Meter,44049.197,45543,1493.803,974,10.301,3.376925957,TRUE
55645,43863,2021-07-29T06:04:55,423490663,01/07/2021 10:15,Meter,42272,43216,944,647,6.4125,3.603453077,TRUE
55553,75850,2021-07-29T06:04:55,1497245454,01/07/2021 10:15,Meter,73080,74738,1658,1112,12.312,3.225656734,TRUE
55594,44265,2021-07-29T06:04:55,1497181975,01/07/2021 10:15,Meter,42439,43525,1086,740,7.6545,3.452684229,TRUE
51504,53421,2021-07-29T06:04:56,2034025161,01/07/2021 10:15,Meter,51487,52632,1145,789,6.912,4.076760913,TRUE
55346,46568,2021-07-29T06:04:56,960304950,01/07/2021 10:15,Meter,44998,45946,948,622,5.67,3.917863442,TRUE
55625,51213,2021-07-29T06:04:56,1765827103,01/07/2021 10:15,Meter,49232,50420,1188,793,7.425,3.814333814,TRUE
55695,41613,2021-07-29T06:04:57,154958167,01/07/2021 10:15,Meter,39965,40979,1014,634,6.156,3.678176924,TRUE
55449,70317,2021-07-29T06:04:57,154972740,01/07/2021 10:15,Meter,67232,69044,1812,1273,10.5948,4.291188669,TRUE
55593,36065,2021-07-29T06:04:57,960279509,01/07/2021 10:15,Meter,34587,35443,856,622,5.0031,4.440104278,TRUE
55665,37071,2021-07-29T06:04:58,2034047885,01/07/2021 10:15,Meter,35518,36457,939,614,6.5205,3.363019926,TRUE
55677,56297,2021-07-29T06:04:58,1765619376,01/07/2021 10:15,Meter,54250,55496,1246,801,7.371,3.881039595,TRUE
55696,61726,2021-07-29T06:04:58,1497102441,01/07/2021 10:15,Meter,59108,60699,1591,1027,10.26,3.574909496,TRUE
55648,42843,2021-07-29T06:04:58,154976939,01/07/2021 10:15,Meter,41289,42238,949,605,7.182,3.008513347,TRUE
55663,61605,2021-07-29T06:04:59,154998675,01/07/2021 10:15,Meter,59478,60813,1335,792,6.48,4.365079365,TRUE
95676,12668,2021-07-29T06:04:59,1497135786,01/07/2021 10:15,Meter,11603,12250,647,418,4.464,3.34421403,TRUE
82116,35208,2021-07-29T06:04:59,154998428,01/07/2021 10:15,Meter,33150,34393,1243,815,8.37,3.477555897,TRUE
55739,20953,2021-07-29T06:04:59,1765664083,01/07/2021 10:15,Meter,20248,20660,412,293,2.808,3.726597477,TRUE
81537,63000,2021-07-29T06:05:00,1765776715,01/07/2021 10:15,Meter,60398,61941,1543,1059,10.5525,3.584120215,TRUE
55640,35164,2021-07-29T06:05:00,1497245701,01/07/2021 10:15,Meter,33901,34682,781,482,6.156,2.796342709,TRUE
55692,22471,2021-07-29T06:05:00,154921858,01/07/2021 10:15,Meter,21513,22096,583,375,3.528,3.796161322,TRUE
97168,60410,2021-07-29T06:05:00,2034116057,01/07/2021 10:15,Meter,57858,59400,1542,1010,9.72,3.711052322,TRUE
55767,31422,2021-07-29T06:05:01,1497101453,01/07/2021 10:15,Meter,30463,31038,575,384,5.67,2.418745276,TRUE
55783,27859,2021-07-29T06:05:01,154918647,01/07/2021 10:15,Meter,26741,27421,680,438,5.796,2.698905649,TRUE
55673,35883,2021-07-29T06:05:01,154975951,01/07/2021 10:15,Meter,34455,35320,865,563,5.544,3.62682952,TRUE
55769,23584,2021-07-29T06:05:01,2033970080,01/07/2021 10:15,Meter,22611,23212,601,372,4.536,2.928949358,TRUE
55761,62565,2021-07-29T06:05:02,1497187409,01/07/2021 10:15,Meter,60266,61649,1383,916,8.721,3.751208086,TRUE
55372,42327,2021-07-29T06:05:02,423354813,01/07/2021 10:15,Meter,40768,41705,937,622,6.5205,3.406837775,TRUE
55634,74880,2021-07-29T06:05:02,1228742104,01/07/2021 10:15,Meter,72235,73834,1599,1046,9.576,3.901121852,TRUE
24991,47565,2021-07-29T06:05:02,960237272,01/07/2021 10:15,Meter,45842,46884,1042,681,7.236,3.361170339,TRUE
55415,23738,2021-07-29T06:05:02,423354072,01/07/2021 10:15,Meter,22773,23372,599,366,4.032,3.241921769,TRUE
49879,74199,2021-07-29T06:05:03,960230850,01/07/2021 10:15,Meter,71675,73013,1338,1186,9.045,4.682934534,TRUE
48204,149472,2021-07-29T06:05:03,691870266,01/07/2021 10:15,Meter,144103,147357,3254,2115,22.95,3.291316527,TRUE
29112,61620,2021-07-29T06:05:03,960542070,01/07/2021 10:15,Meter,60243,61188,945,432,7.9461,1.941653318,TRUE
55884,51085,2021-07-29T06:05:03,423411623,01/07/2021 10:15,Meter,49097,50296,1199,789,7.56,3.727324263,TRUE
55885,35618,2021-07-29T06:05:04,960230356,01/07/2021 10:15,Meter,34231,35075,844,543,5.481,3.538196888,TRUE
55890,51079,2021-07-29T06:05:04,691795178,01/07/2021 10:16,Meter,49325,50407,1082,672,8.091,2.966258806,TRUE
55893,45294,2021-07-29T06:05:04,2034052825,01/07/2021 10:16,Meter,43489,44588,1099,706,7.1775,3.512962134,TRUE
55894,44277,2021-07-29T06:05:04,2034053072,01/07/2021 10:16,Meter,42399,43545,1146,732,7.1775,3.642334677,TRUE
85583,40765,2021-07-29T06:05:05,2034322549,01/07/2021 10:16,Meter,38359,39721,1362,1044,9.3465,3.989270239,TRUE
56091,42208,2021-07-29T06:05:05,154977433,01/07/2021 10:16,Meter,40903,41661,758,547,10.296,1.897408147,TRUE
86956,43290,2021-07-29T06:05:05,1765713730,01/07/2021 10:16,Meter,40439,42156,1717,1134,10.854,3.731343284,TRUE
56261,82097,2021-07-29T06:05:05,1765586525,01/07/2021 10:16,Meter,78972,80887,1915,1210,12.6,3.429705215,TRUE
56263,69149,2021-07-29T06:05:06,1497151100,01/07/2021 10:16,Meter,66760,68176,1416,973,9.9,3.51010101,TRUE
56292,45255,2021-07-29T06:05:06,1497251382,01/07/2021 10:16,Meter,43443,44505,1062,750,7.946,3.370968322,TRUE
56293,65218,2021-07-29T06:05:06,1497154311,01/07/2021 10:16,Meter,62997,64318,1321,900,8.2404,3.900642826,TRUE
55359,56320,2021-07-29T06:05:06,960228627,01/07/2021 10:16,Meter,54142,55419,1277,901,7.0632,4.555806352,TRUE
56804,50199,2021-07-29T06:05:07,2034024914,01/07/2021 10:16,Meter,48303,49458,1155,741,7.425,3.564213564,TRUE
56137,223573,2021-07-29T06:05:07,960315818,01/07/2021 10:16,Meter,215499,220162,4663,3411,27.216,4.476095994,TRUE
27550,65013,2021-07-29T06:05:07,154943841,01/07/2021 10:16,Meter,62981,64217,1236,796,8.663,3.281608153,TRUE
63314,272023,2021-07-29T06:05:08,960237519,01/07/2021 10:16,Meter,264590,268566,3976,3457,47.088,2.621990437,TRUE
80851,34990,2021-07-29T06:05:08,691932016,01/07/2021 10:16,Meter,33341,34326,985,664,7.2,3.293650794,TRUE
54161,29363,2021-07-29T06:05:08,154918400,01/07/2021 10:16,Meter,28209,28851,642,512,4.536,4.031242126,TRUE
56855,40782,2021-07-29T06:05:08,1228664299,01/07/2021 10:16,Meter,39197,40131,934,651,5.67,4.100529101,TRUE
56856,35298,2021-07-29T06:05:09,960366206,01/07/2021 10:16,Meter,33934,34771,837,527,4.59,4.100529101,TRUE
56858,51258,2021-07-29T06:05:09,691846060,01/07/2021 10:16,Meter,49222,50476,1254,782,7.02,3.978428978,TRUE
57117,53050,2021-07-29T06:05:09,1228694927,01/07/2021 10:16,Meter,51011,52257,1246,793,7.452,3.800513764,TRUE
57118,64312,2021-07-29T06:05:09,691822842,01/07/2021 10:16,Meter,62045,63433,1388,879,8.2404,3.809627827,TRUE
27355,67590,2021-07-29T06:05:10,2034000214,01/07/2021 10:16,Meter,65773,67032,1259,558,9.45,2.108843537,TRUE
25018,52815,2021-07-29T06:05:10,1497120472,01/07/2021 10:16,Meter,51095,52134,1039,681,6.9345,3.50730818,TRUE
81393,45017,2021-07-29T06:05:10,423689745,01/07/2021 10:16,Meter,42580,44180,1600,837,9.6255,3.105590062,TRUE
57335,33325,2021-07-29T06:05:11,154971752,01/07/2021 10:16,Meter,31946,32783,837,542,5.4,3.584656085,TRUE
57125,66434,2021-07-29T06:05:11,1228706783,01/07/2021 10:16,Meter,63835,65466,1631,968,11.0565,3.126796778,TRUE
57154,52787,2021-07-29T06:05:11,2034058506,01/07/2021 10:16,Meter,50551,51903,1352,884,10.08,3.132086168,TRUE
55748,25860,2021-07-29T06:05:11,1228793480,01/07/2021 10:16,Meter,24813,25440,627,420,3.969,3.779289494,TRUE
57163,53476,2021-07-29T06:05:12,154925069,01/07/2021 10:16,Meter,51022,52509,1487,967,10.962,3.150493914,TRUE
57160,40221,2021-07-29T06:05:12,2034090369,01/07/2021 10:16,Meter,38958,39742,784,479,9,1.900793651,TRUE
57167,58167,2021-07-29T06:05:12,154999663,01/07/2021 10:16,Meter,55792,57287,1495,880,6.156,5.105355983,TRUE
57168,64090,2021-07-29T06:05:12,1497220013,01/07/2021 10:16,Meter,61434,63013,1579,1077,10.26,3.748955723,TRUE
57217,51733,2021-07-29T06:05:13,1228784094,01/07/2021 10:16,Meter,49602,50917,1315,816,9.45,3.083900227,TRUE
72176,72325,2021-07-29T06:05:13,423354319,01/07/2021 10:16,Meter,68964,71018,2054,1307,12.96,3.601741623,TRUE
78347,37402,2021-07-29T06:05:13,1228842633,01/07/2021 10:16,Meter,36012,36846,834,556,9.045,2.195372345,TRUE
57252,11496,2021-07-29T06:05:13,960348422,01/07/2021 10:16,Meter,11194,11380,186,116,2.025,2.045855379,TRUE
57227,55437,2021-07-29T06:05:14,423445462,01/07/2021 10:16,Meter,53288,54591,1303,846,8.244,3.665003119,TRUE
57257,22331,2021-07-29T06:05:14,960319029,01/07/2021 10:16,Meter,21406,21967,561,364,3.51,3.703703704,TRUE
81603,17434,2021-07-29T06:05:14,1765665565,01/07/2021 10:16,Meter,16479,17058,579,376,4.455,3.014269681,TRUE
57426,47382,2021-07-29T06:05:14,2034053319,01/07/2021 10:16,Meter,45353,46560,1207,822,7.952,3.691793619,TRUE
46232,63691,2021-07-29T06:05:15,1228676155,01/07/2021 10:16,Meter,61070,62695,1625,996,10.557,3.369463728,TRUE
57430,47936,2021-07-29T06:05:15,1765532926,01/07/2021 10:16,Meter,46172,47018,846,918,7.1415,4.590872266,TRUE
57444,60206,2021-07-29T06:05:15,691937697,01/07/2021 10:16,Meter,57971,59341,1370,865,9.45,3.269085412,TRUE
57453,64722,2021-07-29T06:05:15,1765531691,01/07/2021 10:16,Meter,62355,63801,1446,921,6.804,4.834341144,TRUE
58195,41882,2021-07-29T06:05:16,2033972550,01/07/2021 10:16,Meter,40339,41240,901,642,5.76,3.980654762,TRUE
58197,32554,2021-07-29T06:05:16,2034090863,01/07/2021 10:16,Meter,31136,31963,827,591,5.391,3.915255585,TRUE
58214,62446,2021-07-29T06:05:16,2034000955,01/07/2021 10:16,Meter,59723,61419,1696,1027,10.247,3.579444855,TRUE
58223,82594,2021-07-29T06:05:16,1765679397,01/07/2021 10:16,Meter,80082,81630,1548,964,12.15,2.833627278,TRUE
57477,22024,2021-07-29T06:05:17,423498567,01/07/2021 10:16,Meter,21442,21787,345,237,4.5,1.880952381,TRUE
57482,21120,2021-07-29T06:05:17,691937944,01/07/2021 10:16,Meter,20009,20672,663,448,4.5,3.555555556,TRUE
57485,30578,2021-07-29T06:05:17,423481771,01/07/2021 10:16,Meter,29387,30091,704,487,4.5,3.865079365,TRUE
57491,41562,2021-07-29T06:05:17,423491157,01/07/2021 10:16,Meter,39788,40876,1088,686,6.975,3.512544803,TRUE
57503,47164,2021-07-29T06:05:18,1765633208,01/07/2021 10:16,Meter,45591,46542,951,622,6.237,3.561694038,TRUE
57484,33262,2021-07-29T06:05:18,691937203,01/07/2021 10:16,Meter,32086,32810,724,452,5.4,2.989417989,TRUE
57529,48402,2021-07-29T06:05:18,1228665781,01/07/2021 10:16,Meter,46464,47653,1189,749,9.072,2.948633157,TRUE
57541,35179,2021-07-29T06:05:19,960277780,01/07/2021 10:16,Meter,33888,34651,763,528,4.5,4.19047619,TRUE
57429,43548,2021-07-29T06:05:19,2034115069,01/07/2021 10:16,Meter,41925,42904,979,644,6.3,3.650793651,TRUE
56578,66909,2021-07-29T06:05:19,2034114822,01/07/2021 10:16,Meter,64498,65936,1438,973,8.3835,4.145046818,TRUE
57452,61633,2021-07-29T06:05:19,1765618388,01/07/2021 10:16,Meter,58682,60401,1719,1232,9.45,4.656084656,TRUE
55586,78719,2021-07-29T06:05:20,1765632714,01/07/2021 10:16,Meter,75895,77579,1684,1140,11.5425,3.527336861,TRUE
25313,60389,2021-07-29T06:05:20,1228796444,01/07/2021 10:16,Meter,57967,59443,1476,946,8.829,3.82667508,TRUE
58984,60309,2021-07-29T06:05:20,1497178023,01/07/2021 10:16,Meter,57831,59312,1481,997,9,3.956349206,TRUE
59004,50791,2021-07-29T06:05:20,691909045,01/07/2021 10:16,Meter,49012,50101,1089,690,6.804,3.621819098,TRUE
57806,154513,2021-07-29T06:05:21,2034086417,01/07/2021 10:16,Meter,148277,152013,3736,2500,22.275,4.008337342,TRUE
57794,27558,2021-07-29T06:05:21,1228695174,01/07/2021 10:16,Meter,26102,26986,884,572,5.85,3.492063492,TRUE
80897,48820,2021-07-29T06:05:22,960553185,01/07/2021 10:16,Meter,46070,47698,1628,1122,9.936,4.032953761,TRUE
57221,91790,2021-07-29T06:05:22,155019670,01/07/2021 10:16,Meter,88615,90555,1940,1235,15.3036,2.882141644,TRUE
60950,56606,2021-07-29T06:05:22,1497191114,01/07/2021 10:16,Meter,53594,55400,1806,1206,12.42,3.467908903,TRUE
24928,57484,2021-07-29T06:05:22,691914726,01/07/2021 10:16,Meter,55290,56601,1311,883,8.24,3.827149792,TRUE
60048,41413,2021-07-29T06:05:23,423503754,01/07/2021 10:16,Meter,39872,40768,896,645,6.3,3.656462585,TRUE
60089,70054,2021-07-29T06:05:24,2034020962,01/07/2021 10:16,Meter,67695,69175,1480,879,9,3.488095238,TRUE
69961,68096,2021-07-29T06:05:24,960357808,01/07/2021 10:16,Meter,65385,67190,1805,906,12.11,2.671935826,TRUE
60138,54381,2021-07-29T06:05:24,2033967363,01/07/2021 10:16,Meter,52533,53653,1120,728,6.75,3.851851852,TRUE
60324,81948,2021-07-29T06:05:24,423365434,01/07/2021 10:16,Meter,79121,80830,1709,1118,11.489,3.47537396,TRUE
60344,69418,2021-07-29T06:05:25,1228714193,01/07/2021 10:16,Meter,66541,68274,1733,1144,11.34,3.602922651,TRUE
60538,83304,2021-07-29T06:05:25,423408659,01/07/2021 10:16,Meter,80931,82344,1413,960,11.4777,2.98715895,TRUE
57134,43208,2021-07-29T06:05:25,154939889,01/07/2021 10:16,Meter,41689,42601,912,607,5.4,4.014550265,TRUE
60159,80232,2021-07-29T06:05:25,1228665040,01/07/2021 10:16,Meter,77375,79085,1710,1147,10.8,3.792989418,TRUE
60544,47250,2021-07-29T06:05:26,2033971315,01/07/2021 10:16,Meter,45321,46419,1098,831,7.29,4.071134627,TRUE
12414,43592,2021-07-29T06:05:27,1228685294,01/07/2021 10:16,Meter,42332,43094,762,498,4.968,3.58005521,TRUE
26361,67443,2021-07-29T06:05:28,691951776,01/07/2021 10:16,Meter,64511,66261,1750,1182,10.584,3.988500162,TRUE
27461,67245,2021-07-29T06:05:28,154937913,01/07/2021 10:16,Meter,65107,66402,1295,843,8.82,3.41350826,TRUE
26492,21922,2021-07-29T06:05:28,1497116026,01/07/2021 10:16,Meter,21236,21650,414,272,2.822,3.442340792,TRUE
55784,32546,2021-07-29T06:05:28,1497096019,01/07/2021 10:16,Meter,31722,32225,503,321,5.4,2.123015873,TRUE
57793,41644,2021-07-29T06:05:29,423388899,01/07/2021 10:16,Meter,40482,41203,721,441,6.75,2.333333333,TRUE
60793,39545,2021-07-29T06:05:29,960231344,01/07/2021 10:16,Meter,38152,39009,857,536,6.552,2.921681493,TRUE
35620,43481,2021-07-29T06:05:29,423384947,01/07/2021 10:16,Meter,41806,42835,1029,646,7.56,3.051776266,TRUE
36368,19320,2021-07-29T06:05:29,423382477,01/07/2021 10:16,Meter,18681,19071,390,249,2.6487,3.357442195,TRUE
60945,101094,2021-07-29T06:05:30,1765587760,01/07/2021 10:16,Meter,97356,99276,1920,1818,13.365,4.858104858,TRUE
27350,43500,2021-07-29T06:05:30,423381983,01/07/2021 10:16,Meter,42178,42972,794,528,5.445,3.463203463,TRUE
61058,39459,2021-07-29T06:05:30,423411870,01/07/2021 10:16,Meter,37978,38840,862,619,5.4,4.093915344,TRUE
61061,56004,2021-07-29T06:05:30,960227145,01/07/2021 10:16,Meter,54281,55322,1041,682,8.325,2.925782926,TRUE
61064,57761,2021-07-29T06:05:31,1497176788,01/07/2021 10:16,Meter,55480,56886,1406,875,9.1233,3.425295672,TRUE
61069,41761,2021-07-29T06:05:31,423357283,01/07/2021 10:16,Meter,40004,41068,1064,693,6.3,3.928571429,TRUE
60090,87460,2021-07-29T06:05:31,2033988852,01/07/2021 10:16,Meter,84362,86180,1818,1280,11.4777,3.982878601,TRUE
61090,109183,2021-07-29T06:05:31,960360772,01/07/2021 10:17,Meter,105420,107688,2268,1495,14.742,3.621819098,TRUE
61148,58439,2021-07-29T06:05:32,2033980454,01/07/2021 10:17,Meter,56137,57489,1352,950,9.675,3.506829088,TRUE
61301,96178,2021-07-29T06:05:32,423479301,01/07/2021 10:17,Meter,92783,94792,2009,1386,12.915,3.832752613,TRUE
61325,77080,2021-07-29T06:05:32,691876441,01/07/2021 10:17,Meter,74285,75937,1652,1143,11.52,3.543526786,TRUE
61338,53114,2021-07-29T06:05:32,1228810029,01/07/2021 10:17,Meter,50346,52034,1688,1080,13.2435,2.912479977,TRUE
61369,83730,2021-07-29T06:05:33,1497098736,01/07/2021 10:17,Meter,80754,82526,1772,1204,9.3555,4.596226818,TRUE
61394,60311,2021-07-29T06:05:33,1765552439,01/07/2021 10:17,Meter,57754,59268,1514,1043,8.694,4.284564067,TRUE
61413,34849,2021-07-29T06:05:33,1765564789,01/07/2021 10:17,Meter,33498,34338,840,511,6.332,2.882185723,TRUE
76305,41719,2021-07-29T06:05:33,1765870328,01/07/2021 10:17,Meter,39222,40743,1521,976,9.72,3.586125808,TRUE
60543,37990,2021-07-29T06:05:34,691794190,01/07/2021 10:17,Meter,36405,37359,954,631,5.94,3.793891294,TRUE
46829,64349,2021-07-29T06:05:36,691809504,01/07/2021 10:17,Meter,61807,63335,1528,1014,10.8,3.353174603,TRUE
61432,65956,2021-07-29T06:05:36,423422738,01/07/2021 10:17,Meter,63415,64921,1506,1035,9.477,3.900420567,TRUE
61281,82839,2021-07-29T06:05:36,691846554,01/07/2021 10:17,Meter,78752,81223,2471,1616,15.892,3.631656539,TRUE
39099,26926,2021-07-29T06:05:36,1497129611,01/07/2021 10:17,Meter,26081,26591,510,335,3.465,3.45289631,TRUE
50554,86476,2021-07-29T06:05:37,1228694680,01/07/2021 10:17,Meter,83229,85139,1910,1337,12.564,3.800541229,TRUE
61054,94741,2021-07-29T06:05:37,155000651,01/07/2021 10:17,Meter,90821,93216,2395,1525,14.1264,3.855496497,TRUE
61488,109340,2021-07-29T06:05:37,154951498,01/07/2021 10:17,Meter,105197,107033,1836,2307,17.0694,4.82693341,TRUE
49761,60012,2021-07-29T06:05:38,2034021950,01/07/2021 10:17,Meter,58009,59206,1197,806,9.576,3.006026972,TRUE
55541,46235,2021-07-29T06:05:38,155041900,01/07/2021 10:17,Meter,44412,45529,1117,706,6.804,3.705803309,TRUE
61373,16479,2021-07-29T06:05:38,691803329,01/07/2021 10:17,Meter,15860,16233,373,246,2.309,3.804986698,TRUE
62213,31776,2021-07-29T06:05:39,691901635,01/07/2021 10:17,Meter,30262,31161,899,615,5.886,3.73161497,TRUE
62293,19889,2021-07-29T06:05:39,1497177529,01/07/2021 10:17,Meter,18948,19522,574,367,4.68,2.800671551,TRUE
62298,66339,2021-07-29T06:05:39,1228784588,01/07/2021 10:17,Meter,63870,65363,1493,976,9.09,3.834669181,TRUE
62300,50521,2021-07-29T06:05:39,2034058259,01/07/2021 10:17,Meter,48991,49931,940,590,7.65,2.754435107,TRUE
62439,39905,2021-07-29T06:05:40,1228772485,01/07/2021 10:17,Meter,38117,39187,1070,718,6.516,3.935367886,TRUE
62464,48353,2021-07-29T06:05:40,960338295,01/07/2021 10:17,Meter,45881,47381,1500,972,9.72,3.571428571,TRUE
62516,50051,2021-07-29T06:05:40,960351633,01/07/2021 10:17,Meter,49091,49702,611,349,7.875,1.58276644,TRUE
62511,37894,2021-07-29T06:05:40,1497097748,01/07/2021 10:17,Meter,37159,37583,424,311,5.4,2.056878307,TRUE
62509,34433,2021-07-29T06:05:41,691922877,01/07/2021 10:17,Meter,33137,33892,755,541,4.725,4.089191232,TRUE
62521,22565,2021-07-29T06:05:41,1765588748,01/07/2021 10:17,Meter,21558,22167,609,398,3.78,3.760393046,TRUE
62530,75776,2021-07-29T06:05:41,154976692,01/07/2021 10:17,Meter,72524,74510,1986,1266,12.663,3.570582462,TRUE
62567,67122,2021-07-29T06:05:41,1228719380,01/07/2021 10:17,Meter,64338,66051,1713,1071,13.041,2.933057281,TRUE
62569,43278,2021-07-29T06:05:42,154925316,01/07/2021 10:17,Meter,41830,42715,885,563,7.2,2.79265873,TRUE
62583,26493,2021-07-29T06:05:42,2034022197,01/07/2021 10:17,Meter,25344,26035,691,458,4.698,3.481724746,TRUE
62589,39698,2021-07-29T06:05:42,691797154,01/07/2021 10:17,Meter,38018,39030,1012,668,5.85,4.078144078,TRUE
62725,42483,2021-07-29T06:05:42,2034079501,01/07/2021 10:17,Meter,41033,41907,874,576,5.589,3.680699333,TRUE
62798,82835,2021-07-29T06:05:43,1765589489,01/07/2021 10:17,Meter,79665,81618,1953,1217,11.34,3.832829428,TRUE
62877,41473,2021-07-29T06:05:43,155041653,01/07/2021 10:17,Meter,39565,40730,1165,743,8.55,3.103592314,TRUE
62886,85863,2021-07-29T06:05:43,960278521,01/07/2021 10:17,Meter,82224,84352,2128,1511,10.8,4.996693122,TRUE
62904,55712,2021-07-29T06:05:43,1228753219,01/07/2021 10:17,Meter,53368,54774,1406,938,10.773,3.109625917,TRUE
62912,70846,2021-07-29T06:05:44,960280991,01/07/2021 10:17,Meter,67533,69578,2045,1268,15.66,2.891808064,TRUE
62946,39919,2021-07-29T06:05:44,691794931,01/07/2021 10:17,Meter,38206,39249,1043,670,5.9535,4.019244382,TRUE
62969,54797,2021-07-29T06:05:44,1228712217,01/07/2021 10:17,Meter,52652,53975,1323,822,8.91,3.294853295,TRUE
55736,42385,2021-07-29T06:05:44,423569703,01/07/2021 10:17,Meter,40596,41699,1103,686,8.1,3.024691358,TRUE
63013,56059,2021-07-29T06:05:45,1765626539,01/07/2021 10:17,Meter,54016,54989,973,1070,8.505,4.493155287,TRUE
63021,40211,2021-07-29T06:05:45,1497153076,01/07/2021 10:17,Meter,38872,39673,801,538,5.103,3.765292125,TRUE
88096,44336,2021-07-29T06:05:45,155139959,01/07/2021 10:17,Meter,41790,43358,1568,978,7.128,4.9001924,TRUE
63043,28626,2021-07-29T06:05:45,423502519,01/07/2021 10:17,Meter,27502,28193,691,433,4.725,3.272864701,TRUE
63044,44792,2021-07-29T06:05:46,691795425,01/07/2021 10:17,Meter,42890,44029,1139,763,7.182,3.794207742,TRUE
63057,40267,2021-07-29T06:05:46,1497209886,01/07/2021 10:17,Meter,38383,39508,1125,759,8.37,3.238607271,TRUE
63062,31391,2021-07-29T06:05:46,155068329,01/07/2021 10:17,Meter,30185,30912,727,479,4.617,3.705250781,TRUE
63066,56537,2021-07-29T06:05:46,423486958,01/07/2021 10:17,Meter,54805,55896,1091,641,10.35,2.211870255,TRUE
63086,41422,2021-07-29T06:05:47,691913244,01/07/2021 10:17,Meter,40103,40904,801,518,6.57,2.815829528,TRUE
63090,77455,2021-07-29T06:05:47,1497207910,01/07/2021 10:17,Meter,74213,76193,1980,1262,11.4777,3.92686937,TRUE
63127,55562,2021-07-29T06:05:47,2034051837,01/07/2021 10:17,Meter,53577,54751,1174,811,7.6545,3.783955283,TRUE
63242,17319,2021-07-29T06:05:47,2034024173,01/07/2021 10:17,Meter,16482,16989,507,330,3.402,3.464348702,TRUE
63244,78578,2021-07-29T06:05:48,1765658896,01/07/2021 10:17,Meter,76246,77598,1352,980,13.05,2.681992337,TRUE
63136,60036,2021-07-29T06:05:48,2033994286,01/07/2021 10:17,Meter,57999,59225,1226,811,9.3555,3.095963413,TRUE
40102,71366,2021-07-29T06:05:48,1765665318,01/07/2021 10:17,Meter,68932,70406,1474,960,9.9,3.463203463,TRUE
73953,39486,2021-07-29T06:05:49,692124182,01/07/2021 10:17,Meter,37755,38802,1047,684,7.02,3.47985348,TRUE
63614,53322,2021-07-29T06:05:49,1497232610,01/07/2021 10:17,Meter,51384,52579,1195,743,10.8,2.457010582,TRUE
63631,49255,2021-07-29T06:05:49,960338542,01/07/2021 10:17,Meter,47009,48354,1345,901,8.64,3.724371693,TRUE
63639,36562,2021-07-29T06:05:49,155046099,01/07/2021 10:17,Meter,34955,35924,969,638,6.3,3.616780045,TRUE
63676,31524,2021-07-29T06:05:50,691868537,01/07/2021 10:17,Meter,30372,31069,697,455,4.32,3.761574074,TRUE
63721,61597,2021-07-29T06:05:50,155003615,01/07/2021 10:17,Meter,58732,60479,1747,1118,12.096,3.300973167,TRUE
63722,64096,2021-07-29T06:05:50,1497215073,01/07/2021 10:17,Meter,61366,62966,1600,1130,10.517,3.837324604,TRUE
63733,36014,2021-07-29T06:05:50,155037207,01/07/2021 10:17,Meter,34562,35426,864,588,6.21,3.381642512,TRUE
63757,64005,2021-07-29T06:05:51,1765612954,01/07/2021 10:17,Meter,61208,62906,1698,1099,10.206,3.845776994,TRUE
63762,33075,2021-07-29T06:05:51,1765677174,01/07/2021 10:17,Meter,31695,32528,833,547,5.67,3.445452255,TRUE
63776,62793,2021-07-29T06:05:52,1228787799,01/07/2021 10:17,Meter,60204,61629,1425,1164,11.25,3.695238095,TRUE
63780,38338,2021-07-29T06:05:53,1228797432,01/07/2021 10:17,Meter,36720,37694,974,644,6.048,3.802910053,TRUE
63783,68943,2021-07-29T06:05:53,691916949,01/07/2021 10:17,Meter,66337,67920,1583,1023,9.712,3.761914568,TRUE
63784,38823,2021-07-29T06:05:53,2034100249,01/07/2021 10:17,Meter,37173,38175,1002,648,6.75,3.428571429,TRUE
63803,76174,2021-07-29T06:05:53,423518821,01/07/2021 10:17,Meter,72552,74699,2147,1475,12.6,4.180839002,TRUE
63818,39696,2021-07-29T06:05:54,960352621,01/07/2021 10:17,Meter,38698,39313,615,383,7.425,1.842231842,TRUE
63832,37404,2021-07-29T06:05:54,423482265,01/07/2021 10:17,Meter,36122,36798,676,606,5.85,3.6996337,TRUE
63766,46420,2021-07-29T06:05:54,1228740375,01/07/2021 10:17,Meter,44167,45535,1368,885,9.072,3.484032502,TRUE
63778,63036,2021-07-29T06:05:54,2034092592,01/07/2021 10:17,Meter,60237,61925,1688,1111,11.6235,3.413650917,TRUE
63794,121333,2021-07-29T06:05:55,2034045909,01/07/2021 10:17,Meter,116396,119324,2928,2009,22.113,3.244697689,TRUE
63805,35745,2021-07-29T06:05:55,2034092839,01/07/2021 10:17,Meter,33960,35053,1093,692,7.938,3.113414678,TRUE
63815,22331,2021-07-29T06:05:55,1497241008,01/07/2021 10:17,Meter,21406,21965,559,366,4.104,3.185045948,TRUE
63684,36487,2021-07-29T06:05:55,155037948,01/07/2021 10:17,Meter,35241,35999,758,488,6.048,2.881708239,TRUE
62810,67328,2021-07-29T06:05:56,960276298,01/07/2021 10:17,Meter,64292,66098,1806,1230,11.232,3.911019536,TRUE
62826,37473,2021-07-29T06:05:56,423440769,01/07/2021 10:17,Meter,35771,36781,1010,692,6.552,3.772021629,TRUE
81647,83362,2021-07-29T06:05:56,423678136,01/07/2021 10:17,Meter,78784,81668,2884,1694,15.552,3.890174897,TRUE
63773,51094,2021-07-29T06:05:56,154918894,01/07/2021 10:17,Meter,48579,50090,1511,1004,10.5165,3.409608031,TRUE
62785,52344,2021-07-29T06:05:57,1228717651,01/07/2021 10:17,Meter,50565,51636,1071,708,6.804,3.716301335,TRUE
62791,39320,2021-07-29T06:05:57,154924081,01/07/2021 10:17,Meter,38066,38660,594,660,8.208,2.87176274,TRUE
63765,43670,2021-07-29T06:05:57,691843837,01/07/2021 10:17,Meter,41454,42799,1345,871,9.3555,3.325011262,TRUE
63769,48904,2021-07-29T06:05:58,2034047638,01/07/2021 10:17,Meter,46529,47975,1446,929,9.072,3.657249937,TRUE
62928,16764,2021-07-29T06:05:58,2034048873,01/07/2021 10:17,Meter,15996,16460,464,304,2.97,3.655603656,TRUE
63804,51212,2021-07-29T06:05:58,1765538113,01/07/2021 10:17,Meter,48609,49932,1323,1280,11.592,3.943606428,TRUE
14970,41727,2021-07-29T06:05:58,691917690,01/07/2021 10:17,Meter,40535,41173,638,554,4.523,4.37446701,TRUE
63918,45931,2021-07-29T06:05:59,423435088,01/07/2021 10:17,Meter,43384,44950,1566,981,10.773,3.252178064,TRUE
86318,21378,2021-07-29T06:05:59,692139249,01/07/2021 10:17,Meter,19781,20755,974,623,5.508,4.039578794,TRUE
64011,42022,2021-07-29T06:05:59,423466210,01/07/2021 10:17,Meter,40303,41329,1026,693,6.21,3.985507246,TRUE
67253,52544,2021-07-29T06:05:59,423473373,01/07/2021 10:17,Meter,50200,51608,1408,936,9.4176,3.549584972,TRUE
67257,58294,2021-07-29T06:06:00,1497237550,01/07/2021 10:18,Meter,55954,57388,1434,906,9.18,3.524743231,TRUE
64189,36443,2021-07-29T06:06:00,423470656,01/07/2021 10:18,Meter,35042,35881,839,562,5.103,3.933260547,TRUE
64191,29569,2021-07-29T06:06:00,1228762852,01/07/2021 10:18,Meter,28264,29043,779,526,4.617,4.06881401,TRUE
64202,67171,2021-07-29T06:06:00,155032020,01/07/2021 10:18,Meter,63975,65876,1901,1295,10.8,4.282407407,TRUE
64205,33673,2021-07-29T06:06:01,155065365,01/07/2021 10:18,Meter,32511,33171,660,502,5.643,3.177134756,TRUE
64210,43525,2021-07-29T06:06:01,960341012,01/07/2021 10:18,Meter,41655,42758,1103,767,6.804,4.025993113,TRUE
64211,44007,2021-07-29T06:06:01,691953258,01/07/2021 10:18,Meter,42070,43256,1186,751,7.65,3.506069094,TRUE
64217,36679,2021-07-29T06:06:01,1497212603,01/07/2021 10:18,Meter,34772,35933,1161,746,10.26,2.596769702,TRUE
64218,26961,2021-07-29T06:06:02,423481030,01/07/2021 10:18,Meter,25629,26437,808,524,5.175,3.616287095,TRUE
64220,18096,2021-07-29T06:06:02,2034094321,01/07/2021 10:18,Meter,17667,17942,275,154,3.375,1.62962963,TRUE
64225,28959,2021-07-29T06:06:02,1765668035,01/07/2021 10:18,Meter,28173,28653,480,306,5.85,1.868131868,TRUE
64227,37162,2021-07-29T06:06:03,1228716416,01/07/2021 10:18,Meter,35650,36575,925,587,6.237,3.361277171,TRUE
64231,30216,2021-07-29T06:06:03,691908057,01/07/2021 10:18,Meter,28749,29613,864,603,5.4,3.988095238,TRUE
64235,39217,2021-07-29T06:06:03,1228782859,01/07/2021 10:18,Meter,37796,38655,859,562,5.67,3.539934492,TRUE
64237,38137,2021-07-29T06:06:03,2034021209,01/07/2021 10:18,Meter,36391,37461,1070,676,7.088,3.406159303,TRUE
64241,44758,2021-07-29T06:06:04,960359043,01/07/2021 10:18,Meter,42730,43964,1234,794,8.505,3.334173175,TRUE
64243,54104,2021-07-29T06:06:04,1765652474,01/07/2021 10:18,Meter,51852,53208,1356,896,9.45,3.386243386,TRUE
64244,22494,2021-07-29T06:06:04,1497256322,01/07/2021 10:18,Meter,21482,22088,606,406,3.969,3.653313177,TRUE
64248,27844,2021-07-29T06:06:04,154923340,01/07/2021 10:18,Meter,26742,27411,669,433,4.253,3.636088811,TRUE
64250,53748,2021-07-29T06:06:04,1765658649,01/07/2021 10:18,Meter,51421,52795,1374,953,7.875,4.321995465,TRUE
64252,30365,2021-07-29T06:06:05,691905834,01/07/2021 10:18,Meter,28994,29822,828,543,7.29,2.660199882,TRUE
13998,66602,2021-07-29T06:06:06,960277039,01/07/2021 10:18,Meter,64371,65724,1353,878,8.775,3.573463573,TRUE
19665,95497,2021-07-29T06:06:06,2034046650,01/07/2021 10:18,Meter,92250,94219,1969,1278,12.168,3.751056636,TRUE
63747,34782,2021-07-29T06:06:06,155051286,01/07/2021 10:18,Meter,33239,34137,898,645,5.2974,4.34849441,TRUE
63837,87333,2021-07-29T06:06:08,1228794962,01/07/2021 10:18,Meter,84673,86276,1603,1057,12.6,2.996031746,TRUE
38315,90032,2021-07-29T06:06:08,1497316096,01/07/2021 10:18,Meter,87198,88910,1712,1122,11.178,3.584847788,TRUE
62828,50123,2021-07-29T06:06:09,1228815463,01/07/2021 10:18,Meter,48145,49309,1164,814,7.776,3.738609641,TRUE
65568,59622,2021-07-29T06:06:09,423467692,01/07/2021 10:18,Meter,57239,58681,1442,941,6.804,4.939321408,TRUE
46764,54968,2021-07-29T06:06:09,2034085182,01/07/2021 10:18,Meter,52849,54115,1266,853,8.424,3.6163682,TRUE
46063,42463,2021-07-29T06:06:09,2034094815,01/07/2021 10:18,Meter,40869,41840,971,623,8.064,2.759176587,TRUE
28955,55802,2021-07-29T06:06:10,1765848839,01/07/2021 10:18,Meter,53490,54868,1378,934,10.584,3.151657488,TRUE
64529,83328,2021-07-29T06:06:10,155084137,01/07/2021 10:18,Meter,79179,81606,2427,1722,16.583,3.708617259,TRUE
64536,63116,2021-07-29T06:06:10,1228793974,01/07/2021 10:18,Meter,60417,62049,1632,1067,11.457,3.326101323,TRUE
64537,100809,2021-07-29T06:06:10,691891261,01/07/2021 10:18,Meter,96443,99109,2666,1700,16.281,3.729149666,TRUE
64564,21248,2021-07-29T06:06:11,1228805830,01/07/2021 10:18,Meter,20299,20880,581,368,4.041,3.252377417,TRUE
64569,32106,2021-07-29T06:06:11,1228753960,01/07/2021 10:18,Meter,30132,31356,1224,750,9.418,2.844097928,TRUE
81628,44468,2021-07-29T06:06:11,1228802619,01/07/2021 10:18,Meter,41921,43470,1549,998,10.08,3.535997732,TRUE
80643,51479,2021-07-29T06:06:11,1497218037,01/07/2021 10:18,Meter,48503,50229,1726,1250,11.421,3.908839606,TRUE
64611,36603,2021-07-29T06:06:12,423479548,01/07/2021 10:18,Meter,34581,35791,1210,812,7.452,3.891572732,TRUE
64634,42210,2021-07-29T06:06:12,423480042,01/07/2021 10:18,Meter,40271,41444,1173,766,8.136,3.362480685,TRUE
64638,46801,2021-07-29T06:06:12,2034112105,01/07/2021 10:18,Meter,44199,45788,1589,1013,9.6255,3.758617363,TRUE
64647,56236,2021-07-29T06:06:12,960337307,01/07/2021 10:18,Meter,54632,55595,963,641,9.126,2.508531355,TRUE
64653,80089,2021-07-29T06:06:13,960319523,01/07/2021 10:18,Meter,76491,78640,2149,1449,14.283,3.623188406,TRUE
64655,54601,2021-07-29T06:06:13,1497208404,01/07/2021 10:18,Meter,52202,53659,1457,942,9.9,3.398268398,TRUE
64673,75909,2021-07-29T06:06:13,1228779895,01/07/2021 10:18,Meter,72812,74694,1882,1215,13.352,3.249914406,TRUE
64726,44256,2021-07-29T06:06:13,1497189138,01/07/2021 10:18,Meter,42482,43578,1096,678,9.315,2.599493904,TRUE
64728,45308,2021-07-29T06:06:13,155031279,01/07/2021 10:18,Meter,43158,44469,1311,839,10.8,2.774470899,TRUE
64853,83439,2021-07-29T06:06:14,1497149371,01/07/2021 10:18,Meter,80055,82102,2047,1337,13.608,3.508965315,TRUE
64854,54529,2021-07-29T06:06:14,960361019,01/07/2021 10:18,Meter,52470,53701,1231,828,7.7166,3.832183678,TRUE
64838,58242,2021-07-29T06:06:14,960281732,01/07/2021 10:18,Meter,56035,57397,1362,845,10.836,2.78502874,TRUE
64855,45365,2021-07-29T06:06:14,691881134,01/07/2021 10:18,Meter,43600,44671,1071,694,8.064,3.073625283,TRUE
65564,45257,2021-07-29T06:06:16,1765651980,01/07/2021 10:18,Meter,43208,44501,1293,756,6.156,4.385964912,TRUE
65571,36843,2021-07-29T06:06:16,1497189879,01/07/2021 10:18,Meter,35145,36161,1016,682,7.02,3.46967847,TRUE
65573,38954,2021-07-29T06:06:16,960337060,01/07/2021 10:18,Meter,37356,38298,942,656,5.589,4.191907574,TRUE
77387,47128,2021-07-29T06:06:17,1228956006,01/07/2021 10:18,Meter,43007,45449,2442,1679,16.848,3.559133767,TRUE
65754,63586,2021-07-29T06:06:17,960337801,01/07/2021 10:18,Meter,61190,62615,1425,971,8.829,3.927802857,TRUE
66566,33934,2021-07-29T06:06:17,1497099724,01/07/2021 10:18,Meter,32719,33439,720,495,4.86,3.637566138,TRUE
66414,28393,2021-07-29T06:06:18,1228823120,01/07/2021 10:18,Meter,27444,28024,580,369,4.5,2.928571429,TRUE
64119,72639,2021-07-29T06:06:18,1497098983,01/07/2021 10:18,Meter,69483,71390,1907,1249,13.5945,3.281263957,TRUE
62911,87359,2021-07-29T06:06:18,1228753713,01/07/2021 10:18,Meter,83526,85868,2342,1491,14.5935,3.648884777,TRUE
5931,35658,2021-07-29T06:06:18,423467939,01/07/2021 10:18,Meter,34188,35061,873,597,4.968,4.291752933,TRUE
66981,90774,2021-07-29T06:06:19,1228660841,01/07/2021 10:18,Meter,87018,89302,2284,1472,15.876,3.311377461,TRUE
65761,39407,2021-07-29T06:06:19,960239495,01/07/2021 10:18,Meter,37933,38830,897,577,5.886,3.501043639,TRUE
65764,36520,2021-07-29T06:06:19,155031032,01/07/2021 10:18,Meter,35442,36094,652,426,6.3,2.414965986,TRUE
65775,28530,2021-07-29T06:06:19,1228773720,01/07/2021 10:18,Meter,27650,28177,527,353,5.589,2.255706362,TRUE
66985,23098,2021-07-29T06:06:20,960225663,01/07/2021 10:18,Meter,22225,22752,527,346,3.528,3.502591513,TRUE
65776,16943,2021-07-29T06:06:20,423499308,01/07/2021 10:18,Meter,16213,16656,443,287,3.726,2.750939345,TRUE
65786,48632,2021-07-29T06:06:20,691934980,01/07/2021 10:18,Meter,46833,47927,1094,705,6.831,3.685927599,TRUE
65790,24049,2021-07-29T06:06:20,1228805583,01/07/2021 10:18,Meter,22956,23577,621,472,4.221,3.993637256,TRUE
66883,36136,2021-07-29T06:06:21,691925594,01/07/2021 10:18,Meter,35295,35802,507,334,5.4,2.208994709,TRUE
66094,48232,2021-07-29T06:06:21,155039183,01/07/2021 10:18,Meter,46396,47504,1108,728,6.156,4.223521767,TRUE
66098,47574,2021-07-29T06:06:21,155054991,01/07/2021 10:18,Meter,45661,46844,1183,730,6.48,4.023368607,TRUE
66558,35172,2021-07-29T06:06:22,960229615,01/07/2021 10:18,Meter,33758,34540,782,632,5.94,3.7999038,TRUE
66565,31149,2021-07-29T06:06:22,1228794715,01/07/2021 10:18,Meter,29809,30608,799,541,5.4,3.578042328,TRUE
66480,36848,2021-07-29T06:06:22,1497232363,01/07/2021 10:18,Meter,35455,36287,832,561,5.2785,3.795721187,TRUE
66620,33818,2021-07-29T06:06:23,1497208651,01/07/2021 10:18,Meter,32377,33248,871,570,6.5205,3.122021756,TRUE
66621,54033,2021-07-29T06:06:23,423467445,01/07/2021 10:18,Meter,51628,53090,1462,943,9.347,3.603142337,TRUE
66674,51438,2021-07-29T06:06:23,691902870,01/07/2021 10:18,Meter,49542,50691,1149,747,7.7625,3.436853002,TRUE
66673,12741,2021-07-29T06:06:23,2034089875,01/07/2021 10:18,Meter,12250,12548,298,193,3.726,1.849934821,TRUE
66675,31997,2021-07-29T06:06:24,691882863,01/07/2021 10:18,Meter,30723,31494,771,503,4.7088,3.815045386,TRUE
66678,52302,2021-07-29T06:06:24,2034112599,01/07/2021 10:18,Meter,50301,51514,1213,788,7.7625,3.625488843,TRUE
66567,28294,2021-07-29T06:06:24,960366947,01/07/2021 10:18,Meter,27195,27865,670,429,3.78,4.053287982,TRUE
66681,32413,2021-07-29T06:06:24,155011766,01/07/2021 10:18,Meter,31152,31915,763,498,4.536,3.92101285,TRUE
66684,38367,2021-07-29T06:06:25,1765643829,01/07/2021 10:18,Meter,36693,37720,1027,647,6.4746,3.568891184,TRUE
66685,19157,2021-07-29T06:06:25,423480289,01/07/2021 10:18,Meter,18260,18810,550,347,3.9195,3.161846445,TRUE
66100,34286,2021-07-29T06:06:25,691803576,01/07/2021 10:18,Meter,32984,33754,770,532,5.616,3.383190883,TRUE
66761,67135,2021-07-29T06:06:25,155044617,01/07/2021 10:18,Meter,63856,65860,2004,1275,10.08,4.517431973,TRUE
66771,64168,2021-07-29T06:06:26,154972987,01/07/2021 10:18,Meter,61626,63118,1492,1050,10.944,3.426535088,TRUE
66822,36824,2021-07-29T06:06:26,2033981195,01/07/2021 10:18,Meter,35180,36166,986,658,8.694,2.703013573,TRUE
65828,31031,2021-07-29T06:06:26,691915961,01/07/2021 10:18,Meter,30244,30713,469,318,4.5,2.523809524,TRUE
66542,65283,2021-07-29T06:06:26,155055238,01/07/2021 10:18,Meter,62640,64232,1592,1051,10.0062,3.751245656,TRUE
66568,33902,2021-07-29T06:06:27,155032761,01/07/2021 10:18,Meter,32596,33408,812,494,4.86,3.630217519,TRUE
66946,42979,2021-07-29T06:06:27,155037454,01/07/2021 10:18,Meter,41024,42183,1159,796,7.946,3.577721046,TRUE
69289,80049,2021-07-29T06:06:27,1497210874,01/07/2021 10:18,Meter,77043,78872,1829,1177,12.1095,3.471300573,TRUE
67096,36473,2021-07-29T06:06:27,1765675445,01/07/2021 10:18,Meter,34958,35878,920,595,5.85,3.632478632,TRUE
67142,47650,2021-07-29T06:06:28,1765693970,01/07/2021 10:19,Meter,45364,46701,1337,949,9.123,3.715099983,TRUE
66541,27704,2021-07-29T06:06:28,423476584,01/07/2021 10:19,Meter,26706,27311,605,393,3.78,3.713151927,TRUE
66676,27535,2021-07-29T06:06:31,155038442,01/07/2021 10:19,Meter,26465,27116,651,419,4.0365,3.707242838,TRUE
66679,42390,2021-07-29T06:06:31,1765644076,01/07/2021 10:19,Meter,40568,41677,1109,713,6.5205,3.90526581,TRUE
66680,38242,2021-07-29T06:06:31,960344470,01/07/2021 10:19,Meter,36489,37542,1053,700,6.831,3.659786268,TRUE
66682,34321,2021-07-29T06:06:31,1497241749,01/07/2021 10:19,Meter,32417,33575,1158,746,6.5205,4.086014438,TRUE
66683,41342,2021-07-29T06:06:32,2034086911,01/07/2021 10:19,Meter,39722,40707,985,635,6.3315,3.581863923,TRUE
66999,51587,2021-07-29T06:06:32,1765654450,01/07/2021 10:19,Meter,49322,50669,1347,918,9.18,3.571428571,TRUE
65834,45425,2021-07-29T06:06:32,960339036,01/07/2021 10:19,Meter,43558,44694,1136,731,6.75,3.867724868,TRUE
65835,76888,2021-07-29T06:06:32,423468186,01/07/2021 10:19,Meter,74111,75787,1676,1101,10.8,3.640873016,TRUE
67099,27734,2021-07-29T06:06:32,691914973,01/07/2021 10:19,Meter,26667,27298,631,436,4.5,3.46031746,TRUE
55343,51334,2021-07-29T06:06:35,1228788046,01/07/2021 10:19,Meter,50555,51017,462,317,7.425,1.524771525,TRUE
67258,68255,2021-07-29T06:06:35,155048322,01/07/2021 10:19,Meter,65458,67009,1551,1246,10.044,4.430505775,TRUE
67259,53229,2021-07-29T06:06:38,960312360,01/07/2021 10:19,Meter,50758,52252,1494,977,9.4176,3.705068929,TRUE
67471,30741,2021-07-29T06:06:40,1497257804,01/07/2021 10:19,Meter,29528,30247,719,494,6.1803,2.854692676,TRUE
67479,33594,2021-07-29T06:06:41,1765622834,01/07/2021 10:19,Meter,32542,33173,631,421,4.5,3.341269841,TRUE
67481,48680,2021-07-29T06:06:41,1228663558,01/07/2021 10:19,Meter,44217,47800,3583,880,9.1233,3.44486879,TRUE
67534,37051,2021-07-29T06:06:41,155040912,01/07/2021 10:19,Meter,35429,36393,964,658,5.94,3.956228956,TRUE
67537,19637,2021-07-29T06:06:41,2034089381,01/07/2021 10:19,Meter,18908,19353,445,284,3.24,3.130511464,TRUE
67586,37246,2021-07-29T06:06:42,691868784,01/07/2021 10:19,Meter,34983,36372,1389,874,10.08,3.096655329,TRUE
67615,47000,2021-07-29T06:06:43,1765610484,01/07/2021 10:19,Meter,44865,46161,1296,839,8.91,3.36299503,TRUE
76967,20974,2021-07-29T06:06:43,1765628021,01/07/2021 10:19,Meter,19871,20553,682,421,4.608,3.262958829,TRUE
68299,26034,2021-07-29T06:06:44,960309890,01/07/2021 10:19,Meter,25617,25617,0,417,6.912,2.154637897,TRUE
67645,53400,2021-07-29T06:06:44,423434100,01/07/2021 10:19,Meter,50755,52374,1619,1026,12.096,3.029336735,TRUE
67665,51185,2021-07-29T06:06:44,154997440,01/07/2021 10:19,Meter,48813,50198,1385,987,9.216,3.824869792,TRUE
62525,90183,2021-07-29T06:06:44,154920623,01/07/2021 10:19,Meter,86823,88860,2037,1323,13.041,3.623188406,TRUE
67100,83158,2021-07-29T06:06:45,1765625304,01/07/2021 10:19,Meter,79538,81747,2209,1411,14.04,3.589234839,TRUE
67763,31795,2021-07-29T06:06:45,691926088,01/07/2021 10:19,Meter,30313,31203,890,592,5.2974,3.991176264,TRUE
67767,45406,2021-07-29T06:06:45,423472632,01/07/2021 10:19,Meter,43577,44690,1113,716,6.831,3.743438526,TRUE
67768,34454,2021-07-29T06:06:45,1497214579,01/07/2021 10:19,Meter,32872,33839,967,615,6.21,3.536922015,TRUE
67772,27401,2021-07-29T06:06:46,691915714,01/07/2021 10:19,Meter,26226,26946,720,455,4.968,3.270933977,TRUE
67774,50558,2021-07-29T06:06:46,1765644570,01/07/2021 10:19,Meter,48574,49760,1186,798,7.425,3.838383838,TRUE
67779,44446,2021-07-29T06:06:46,1765647287,01/07/2021 10:19,Meter,42726,43776,1050,670,6.48,3.692680776,TRUE
67788,58012,2021-07-29T06:06:47,1228793727,01/07/2021 10:19,Meter,55528,56743,1215,1269,9.639,4.701880752,TRUE
64256,21246,2021-07-29T06:06:47,1228694186,01/07/2021 10:19,Meter,20422,20947,525,299,3.3345,3.202450571,TRUE
67543,42147,2021-07-29T06:06:47,423496097,01/07/2021 10:19,Meter,40347,41451,1104,696,6.48,3.835978836,TRUE
51986,32923,2021-07-29T06:06:47,960228874,01/07/2021 10:19,Meter,31654,32427,773,496,4.32,4.100529101,TRUE
64352,35292,2021-07-29T06:06:48,155054250,01/07/2021 10:19,Meter,33982,34835,853,457,5.886,2.772923644,TRUE
94567,21451,2021-07-29T06:06:48,2034125937,01/07/2021 10:19,Meter,20103,20909,806,542,5.913,3.273658525,TRUE
67622,52241,2021-07-29T06:06:48,1228712958,01/07/2021 10:19,Meter,49640,51196,1556,1045,10.692,3.490593768,TRUE
67673,60503,2021-07-29T06:06:48,691891014,01/07/2021 10:19,Meter,57689,59382,1693,1121,10.08,3.971797052,TRUE
47846,128714,2021-07-29T06:06:48,691792214,01/07/2021 10:19,Meter,124586,127070,2484,1644,16.524,3.553273161,TRUE
67331,62224,2021-07-29T06:06:49,1765641112,01/07/2021 10:19,Meter,59484,61166,1682,1058,10.206,3.702303967,TRUE
64581,64586,2021-07-29T06:06:49,2034018986,01/07/2021 10:19,Meter,61406,63307,1901,1279,12.15,3.759553204,TRUE
64015,21708,2021-07-29T06:06:49,1497189385,01/07/2021 10:19,Meter,20875,21380,505,328,3.339,3.508321568,TRUE
46563,106907,2021-07-29T06:06:49,960586777,01/07/2021 10:19,Meter,102425,105139,2714,1768,18.009,3.506183416,TRUE
67649,45666,2021-07-29T06:06:50,1228740622,01/07/2021 10:19,Meter,43208,44696,1488,970,10.935,3.168071069,TRUE
67647,45546,2021-07-29T06:06:50,423434594,01/07/2021 10:19,Meter,43502,44725,1223,821,8.352,3.510707444,TRUE
65740,62338,2021-07-29T06:06:50,2034013799,01/07/2021 10:19,Meter,59887,61351,1464,987,10.449,3.373528567,TRUE
68295,19945,2021-07-29T06:06:51,155020411,01/07/2021 10:19,Meter,19035,19560,525,385,4.617,2.978124323,TRUE
56867,66684,2021-07-29T06:06:51,423360247,01/07/2021 10:19,Meter,63710,65524,1814,1160,11.1834,3.704470146,TRUE
23419,78635,2021-07-29T06:06:51,423487205,01/07/2021 10:19,Meter,75271,77319,2048,1316,6.552,7.173382173,TRUE
67447,50522,2021-07-29T06:06:52,155039677,01/07/2021 10:19,Meter,48854,49860,1006,662,8.208,2.880465052,TRUE
68698,33308,2021-07-29T06:06:52,960388930,01/07/2021 10:19,Meter,32552,33014,462,294,6.3315,1.658374793,TRUE
70082,255247,2021-07-29T06:06:52,1765584549,01/07/2021 10:19,Meter,246982,251920,4938,3327,36.828,3.226388307,TRUE
72805,69520,2021-07-29T06:06:52,2034061470,01/07/2021 10:19,Meter,66677,68392,1715,1128,10.7325,3.753618848,TRUE
46040,32911,2021-07-29T06:06:52,1497155299,01/07/2021 10:19,Meter,31364,32297,933,614,9.005,2.435155073,TRUE
70072,56833,2021-07-29T06:06:53,155119952,01/07/2021 10:19,Meter,54447,55885,1438,948,9.3465,3.622440791,TRUE
69733,29313,2021-07-29T06:06:53,960350398,01/07/2021 10:19,Meter,28231,28891,660,422,5.2785,2.85524838,TRUE
68975,63182,2021-07-29T06:06:53,1497316343,01/07/2021 10:19,Meter,60769,62230,1461,952,9.418,3.610108303,TRUE
79188,42847,2021-07-29T06:06:53,154994229,01/07/2021 10:19,Meter,40353,41834,1481,1013,10.944,3.305790518,TRUE
68393,20973,2021-07-29T06:06:54,1228780389,01/07/2021 10:19,Meter,19570,20424,854,549,5.5917,3.506472604,TRUE
68398,61445,2021-07-29T06:06:54,691905340,01/07/2021 10:19,Meter,59092,60525,1433,920,9.315,3.527336861,TRUE
68404,30931,2021-07-29T06:06:54,1228778907,01/07/2021 10:19,Meter,29622,30416,794,515,5.427,3.389138961,TRUE
68629,34255,2021-07-29T06:06:55,1497129364,01/07/2021 10:19,Meter,32673,33611,938,644,5.67,4.05643739,TRUE
68646,38865,2021-07-29T06:06:55,2034082465,01/07/2021 10:19,Meter,36785,38052,1267,813,9.6255,3.016540885,TRUE
68693,50839,2021-07-29T06:06:55,1765693229,01/07/2021 10:19,Meter,48327,49889,1562,950,9.99,3.396253396,TRUE
68694,15814,2021-07-29T06:06:55,1497212850,01/07/2021 10:19,Meter,15075,15526,451,288,2.565,4.010025063,TRUE
68847,57372,2021-07-29T06:06:56,1228822379,01/07/2021 10:19,Meter,54777,56342,1565,1030,9.36,3.93009768,TRUE
68851,26035,2021-07-29T06:06:56,155039924,01/07/2021 10:19,Meter,24848,25554,706,481,4.536,3.787163013,TRUE
68865,47350,2021-07-29T06:06:56,1497214332,01/07/2021 10:19,Meter,45297,46551,1254,799,8.141,3.505185393,TRUE
68866,49333,2021-07-29T06:06:56,691908304,01/07/2021 10:19,Meter,47619,48650,1031,683,8.505,2.868060805,TRUE
68871,34364,2021-07-29T06:06:57,155034490,01/07/2021 10:19,Meter,33070,33850,780,514,5.103,3.597323703,TRUE
68879,72093,2021-07-29T06:06:57,155081667,01/07/2021 10:19,Meter,69221,70961,1740,1132,11.772,3.434299306,TRUE
68902,41082,2021-07-29T06:06:57,691906081,01/07/2021 10:19,Meter,39479,40451,972,631,6.048,3.726143235,TRUE
68907,49731,2021-07-29T06:06:57,691991049,01/07/2021 10:19,Meter,47440,48816,1376,915,9.648,3.387082445,TRUE
68910,32720,2021-07-29T06:06:58,1765641606,01/07/2021 10:19,Meter,31218,32130,912,590,5.589,3.770160775,TRUE
68919,28711,2021-07-29T06:06:58,1228776190,01/07/2021 10:19,Meter,27439,28214,775,497,4.824,3.679519071,TRUE
68931,54451,2021-07-29T06:06:58,960370158,01/07/2021 10:19,Meter,52516,53753,1237,698,9.072,2.747858403,TRUE
53778,161445,2021-07-29T06:06:58,154919882,01/07/2021 10:19,Meter,158879,160435,1556,1010,10.62,3.396556363,TRUE
62782,34701,2021-07-29T06:06:59,2034047144,01/07/2021 10:19,Meter,33282,34143,861,558,5.103,3.90526581,TRUE
61661,43498,2021-07-29T06:06:59,155042641,01/07/2021 10:19,Meter,41867,42853,986,645,7.92,2.908549784,TRUE
69229,62726,2021-07-29T06:06:59,1228672944,01/07/2021 10:19,Meter,60467,61863,1396,863,10.5948,2.909109051,TRUE
70228,46936,2021-07-29T06:07:04,1765626292,02/07/2021 10:10,Meter,45327,46300,973,636,8.964,2.533945305,TRUE
19816,89418,2021-07-29T06:07:05,691874712,02/07/2021 10:10,Meter,86075,88084,2009,1334,13.365,3.564748009,TRUE
69248,80580,2021-07-29T06:07:05,155043382,02/07/2021 10:10,Meter,76996,79161,2165,1419,14.4207,3.514293441,TRUE
69250,45056,2021-07-29T06:07:05,1497259039,02/07/2021 10:10,Meter,43006,44204,1198,852,9.6255,3.161245798,TRUE
69256,35048,2021-07-29T06:07:05,691915467,02/07/2021 10:10,Meter,33517,34346,829,702,7.0632,3.549584972,TRUE
69036,28692,2021-07-29T06:07:06,1228775696,02/07/2021 10:10,Meter,27175,28096,921,596,6.5205,3.264429765,TRUE
69330,49389,2021-07-29T06:07:06,691904599,02/07/2021 10:10,Meter,47781,48759,978,630,9.315,2.415458937,TRUE
69340,56201,2021-07-29T06:07:06,155028562,02/07/2021 10:10,Meter,53689,55210,1521,991,9.6255,3.67698895,TRUE
69341,27272,2021-07-29T06:07:08,1765656426,02/07/2021 10:10,Meter,26048,26791,743,481,6.21,2.766275592,TRUE
69371,29155,2021-07-29T06:07:09,1228786317,02/07/2021 10:10,Meter,27723,28598,875,557,6.21,3.203358638,TRUE
69404,26152,2021-07-29T06:07:09,155064377,02/07/2021 10:10,Meter,25190,25770,580,382,4.617,2.95491816,TRUE
69415,34751,2021-07-29T06:07:09,1497205934,02/07/2021 10:10,Meter,33137,34120,983,631,8.073,2.791491922,TRUE
67101,177441,2021-07-29T06:07:09,423475843,02/07/2021 10:10,Meter,170665,174666,4001,2775,27.45,3.610460578,TRUE
69641,44830,2021-07-29T06:07:10,1228794468,02/07/2021 10:10,Meter,42951,44093,1142,737,7.875,3.342403628,TRUE
69659,33792,2021-07-29T06:07:10,2034076290,02/07/2021 10:10,Meter,32238,33182,944,610,5.4,4.034391534,TRUE
69661,40874,2021-07-29T06:07:10,1228788540,02/07/2021 10:10,Meter,38804,40059,1255,815,7.0632,4.120956911,TRUE
69680,34831,2021-07-29T06:07:10,960342247,02/07/2021 10:10,Meter,33482,34300,818,531,5.4,3.511904762,TRUE
69696,15985,2021-07-29T06:07:10,1497221495,02/07/2021 10:10,Meter,15349,15735,386,250,2.52,3.5430839,TRUE
57136,32256,2021-07-29T06:07:11,1765535890,02/07/2021 10:10,Meter,30936,31714,778,542,5.13,3.773322194,TRUE
69708,51306,2021-07-29T06:07:11,2034102472,02/07/2021 10:10,Meter,49111,50445,1334,861,9.072,3.389550265,TRUE
69717,77293,2021-07-29T06:07:11,1228777178,02/07/2021 10:10,Meter,73935,75999,2064,1294,13.5378,3.413722002,TRUE
69729,40607,2021-07-29T06:07:12,1497206181,02/07/2021 10:10,Meter,38633,39831,1198,776,8.073,3.432959955,TRUE
69732,36037,2021-07-29T06:07:12,423479054,02/07/2021 10:10,Meter,34247,35344,1097,693,6.521,3.795430149,TRUE
69738,38137,2021-07-29T06:07:12,1497211615,02/07/2021 10:10,Meter,36393,37452,1059,685,6.831,3.581362277,TRUE
69740,33802,2021-07-29T06:07:12,1228770756,02/07/2021 10:11,Meter,32190,33168,978,634,6.633,3.413667593,TRUE
69777,67742,2021-07-29T06:07:13,423408412,02/07/2021 10:11,Meter,64858,66626,1768,1116,10.5948,3.761953303,TRUE
69779,37279,2021-07-29T06:07:13,960334590,02/07/2021 10:11,Meter,35308,36513,1205,766,7.7625,3.524269611,TRUE
69780,37182,2021-07-29T06:07:13,1497221001,02/07/2021 10:11,Meter,35398,36477,1079,705,6.3315,3.976715064,TRUE
69782,31975,2021-07-29T06:07:13,1765645064,02/07/2021 10:11,Meter,30573,31422,849,553,5.2785,3.741593256,TRUE
69842,23346,2021-07-29T06:07:14,1228776931,02/07/2021 10:11,Meter,22277,22928,651,418,4.2525,3.510540018,TRUE
69864,43195,2021-07-29T06:07:14,1228786070,02/07/2021 10:11,Meter,40501,42507,2006,688,6.336,3.878066378,TRUE
69886,23242,2021-07-29T06:07:14,691885580,02/07/2021 10:11,Meter,22074,22790,716,452,4.4145,3.656780415,TRUE
69923,67966,2021-07-29T06:07:14,155080432,02/07/2021 10:11,Meter,63349,66931,3582,1035,11.25,3.285714286,TRUE
69933,55416,2021-07-29T06:07:15,1228825096,02/07/2021 10:11,Meter,52986,54456,1470,960,9.6255,3.561967096,TRUE
69938,50945,2021-07-29T06:07:15,1228777672,02/07/2021 10:11,Meter,48885,50133,1248,812,8.2215,3.527336861,TRUE
69943,21731,2021-07-29T06:07:15,2034081724,02/07/2021 10:11,Meter,20839,21408,569,323,4.536,2.543146888,TRUE
69944,21249,2021-07-29T06:07:15,1228776437,02/07/2021 10:11,Meter,20223,20854,631,395,3.969,3.554331786,TRUE
69945,41297,2021-07-29T06:07:15,1497213591,02/07/2021 10:11,Meter,39409,40561,1152,736,6.237,4.214480405,TRUE
69960,36800,2021-07-29T06:07:16,155044123,02/07/2021 10:11,Meter,35566,36167,601,633,5.76,3.92485119,TRUE
97122,27006,2021-07-29T06:07:16,1765550710,02/07/2021 10:11,Meter,24273,25929,1656,1077,11.232,3.424526862,TRUE
69977,29329,2021-07-29T06:07:16,423473126,02/07/2021 10:11,Meter,28022,28813,791,516,5.346,3.447170114,TRUE
72644,54537,2021-07-29T06:07:16,960303962,02/07/2021 10:11,Meter,51599,53387,1788,1150,11.808,3.47827139,TRUE
70100,35030,2021-07-29T06:07:17,1497221742,02/07/2021 10:11,Meter,32637,34100,1463,930,9.6255,3.450655625,TRUE
70111,96149,2021-07-29T06:07:17,1228789281,02/07/2021 10:11,Meter,91991,94691,2700,1458,17.7885,2.927252358,TRUE
70120,22033,2021-07-29T06:07:17,960343976,02/07/2021 10:11,Meter,21002,21636,634,397,5.103,2.778477646,TRUE
69688,55589,2021-07-29T06:07:18,1497190867,02/07/2021 10:11,Meter,53152,54624,1472,965,9.72,3.545708407,TRUE
70173,33281,2021-07-29T06:07:18,2034092098,02/07/2021 10:11,Meter,31899,32739,840,542,6.03,3.210139777,TRUE
70180,29979,2021-07-29T06:07:18,960349904,02/07/2021 10:11,Meter,28433,29381,948,598,5.589,3.821281599,TRUE
70182,25332,2021-07-29T06:07:18,2034056530,02/07/2021 10:11,Meter,24170,24828,658,504,5.589,3.220611916,TRUE
70187,24477,2021-07-29T06:07:19,155036960,02/07/2021 10:11,Meter,23352,24034,682,443,4.221,3.748265475,TRUE
70191,40162,2021-07-29T06:07:19,154932973,02/07/2021 10:11,Meter,38714,39585,871,577,5.2974,3.890048487,TRUE
70194,32850,2021-07-29T06:07:19,2034059494,02/07/2021 10:11,Meter,30924,32106,1182,744,9.123,2.91257575,TRUE
70210,22953,2021-07-29T06:07:19,2034100743,02/07/2021 10:11,Meter,21863,22523,660,430,3.969,3.869272577,TRUE
70334,18343,2021-07-29T06:07:20,155034737,02/07/2021 10:11,Meter,17632,18058,426,285,3.168,3.2129329,TRUE
61659,42506,2021-07-29T06:07:20,423445709,02/07/2021 10:11,Meter,41092,41868,776,638,6.075,3.750734862,TRUE
69261,134939,2021-07-29T06:07:20,423367904,02/07/2021 10:11,Meter,128544,132245,3701,2694,22.3155,4.311545146,TRUE
67618,65958,2021-07-29T06:07:20,1228748526,02/07/2021 10:11,Meter,63294,64880,1586,1078,10.692,3.600823045,TRUE
67619,32397,2021-07-29T06:07:20,691891508,02/07/2021 10:11,Meter,31025,31844,819,553,10.449,1.890133027,TRUE
69756,66613,2021-07-29T06:07:21,2034068880,02/07/2021 10:11,Meter,63903,65474,1571,1139,10.773,3.775974327,TRUE
70486,50091,2021-07-29T06:07:21,2034077031,02/07/2021 10:11,Meter,47404,49039,1635,1052,9.315,4.033433019,TRUE
70489,43367,2021-07-29T06:07:21,1765626045,02/07/2021 10:11,Meter,41255,42530,1275,837,8.073,3.70281892,TRUE
70092,105575,2021-07-29T06:07:21,1765648522,02/07/2021 10:11,Meter,100155,103468,3313,2107,15.552,4.838605967,TRUE
70084,198394,2021-07-29T06:07:22,2034091851,02/07/2021 10:11,Meter,189910,194787,4877,3607,27.216,4.73329764,TRUE
69294,44302,2021-07-29T06:07:24,2034068633,02/07/2021 10:11,Meter,42170,43475,1305,827,9.0045,3.280105979,TRUE
70755,65795,2021-07-29T06:07:24,2034186946,02/07/2021 10:11,Meter,62724,64585,1861,1210,12.06,3.583274106,TRUE
64583,75151,2021-07-29T06:07:24,1228862640,02/07/2021 10:11,Meter,71769,73826,2057,1325,12.7305,3.717169677,TRUE
67634,55044,2021-07-29T06:07:25,1765611966,02/07/2021 10:11,Meter,53044,54270,1226,774,6.912,3.999255952,TRUE
70491,34220,2021-07-29T06:07:25,2034092345,02/07/2021 10:11,Meter,32692,33630,938,590,6.03,3.494432599,TRUE
70488,50639,2021-07-29T06:07:25,960340024,02/07/2021 10:11,Meter,48510,49794,1284,845,9.005,3.351312763,TRUE
70511,25203,2021-07-29T06:07:25,423456577,02/07/2021 10:11,Meter,24009,24737,728,466,4.968,3.350011502,TRUE
70513,22824,2021-07-29T06:07:26,960343482,02/07/2021 10:11,Meter,21768,22411,643,413,4.824,3.057628524,TRUE
70514,35257,2021-07-29T06:07:26,155044370,02/07/2021 10:11,Meter,33585,34610,1025,647,6.5205,3.543768554,TRUE
70519,38044,2021-07-29T06:07:26,1228758406,02/07/2021 10:11,Meter,36320,37351,1031,693,6.5205,3.795721187,TRUE
70520,17340,2021-07-29T06:07:26,691901882,02/07/2021 10:11,Meter,16635,17065,430,275,2.88,3.410218254,TRUE
70570,48990,2021-07-29T06:07:26,1497229152,02/07/2021 10:11,Meter,46447,47957,1510,1033,9.315,3.960585845,TRUE
70567,23510,2021-07-29T06:07:27,423435582,02/07/2021 10:11,Meter,22736,23204,468,306,4.032,2.710459184,TRUE
67799,23493,2021-07-29T06:07:27,2034083453,02/07/2021 10:11,Meter,22572,23130,558,363,3.402,3.810783573,TRUE
67800,23782,2021-07-29T06:07:27,691905093,02/07/2021 10:11,Meter,22668,23348,680,434,4.536,3.417107584,TRUE
68853,45607,2021-07-29T06:07:27,1765656673,02/07/2021 10:11,Meter,43831,44903,1072,704,7.056,3.563330094,TRUE
68938,23625,2021-07-29T06:07:28,1228713946,02/07/2021 10:11,Meter,22528,23171,643,454,3.6,4.503968254,TRUE
69296,30681,2021-07-29T06:07:28,423463740,02/07/2021 10:11,Meter,29247,30118,871,563,7.371,2.727871775,TRUE
69299,27307,2021-07-29T06:07:28,1765641359,02/07/2021 10:11,Meter,26152,26854,702,453,5.103,3.170403964,TRUE
70990,92390,2021-07-29T06:07:29,960325945,02/07/2021 10:11,Meter,88441,90726,2285,1664,15.624,3.803672006,TRUE
70622,36582,2021-07-29T06:07:29,1497220754,02/07/2021 10:11,Meter,34390,35720,1330,862,9.072,3.393487024,TRUE
70625,41117,2021-07-29T06:07:29,423516104,02/07/2021 10:11,Meter,38235,39947,1712,1170,9.6255,4.341147399,TRUE
70623,37423,2021-07-29T06:07:29,1497258051,02/07/2021 10:11,Meter,35682,36753,1071,670,6.831,3.502938286,TRUE
70632,66014,2021-07-29T06:07:30,1497214826,02/07/2021 10:11,Meter,63386,64938,1552,1076,10.595,3.627047799,TRUE
70633,68468,2021-07-29T06:07:30,1765650992,02/07/2021 10:11,Meter,65625,67336,1711,1132,10.3005,3.924913492,TRUE
70649,23079,2021-07-29T06:07:30,1497309921,02/07/2021 10:11,Meter,22013,22641,628,438,4.968,3.148723257,TRUE
70653,34750,2021-07-29T06:07:30,691908551,02/07/2021 10:11,Meter,33149,34095,946,655,7.0632,3.311934696,TRUE
70665,58687,2021-07-29T06:07:31,691987344,02/07/2021 10:11,Meter,56283,57738,1455,949,9.504,3.566167629,TRUE
70667,26181,2021-07-29T06:07:31,691880146,02/07/2021 10:11,Meter,25043,25724,681,457,6.336,2.575983045,TRUE
70708,56366,2021-07-29T06:07:31,691922383,02/07/2021 10:11,Meter,53742,55327,1585,1039,10.2465,3.62144565,TRUE
70710,65475,2021-07-29T06:07:31,2034064434,02/07/2021 10:11,Meter,62540,64300,1760,1175,12.1905,3.442376089,TRUE
70713,36458,2021-07-29T06:07:32,1765745346,02/07/2021 10:11,Meter,34659,35748,1089,710,6.831,3.712068929,TRUE
70714,39727,2021-07-29T06:07:32,423439040,02/07/2021 10:11,Meter,37815,38933,1118,794,8.64,3.28207672,TRUE
70723,57439,2021-07-29T06:07:32,960339283,02/07/2021 10:11,Meter,55142,56489,1347,950,8.91,3.807920475,TRUE
55513,29800,2021-07-29T06:07:32,154952980,05/07/2021 10:10,Meter,26702,29403,2701,397,4.284,3.309657196,TRUE
71566,74388,2021-07-29T06:07:33,691931275,02/07/2021 10:11,Meter,70892,72971,2079,1417,13.5,3.748677249,TRUE
71571,60402,2021-07-29T06:07:33,2034107165,02/07/2021 10:12,Meter,57439,59236,1797,1166,12.69,3.281549026,TRUE
70619,27855,2021-07-29T06:07:33,1228762111,02/07/2021 10:12,Meter,26322,27277,955,578,7.1415,2.890549204,TRUE
70582,64067,2021-07-29T06:07:33,960239248,02/07/2021 10:12,Meter,60814,62792,1978,1275,14.283,3.18810574,TRUE
70725,74675,2021-07-29T06:07:34,155080679,02/07/2021 10:12,Meter,66579,73361,6782,1314,12.3606,3.796625684,TRUE
70732,22112,2021-07-29T06:07:34,2034129395,02/07/2021 10:12,Meter,20969,21434,465,678,5.13,4.720133668,TRUE
69798,78445,2021-07-29T06:07:34,155063883,02/07/2021 10:12,Meter,74906,77005,2099,1440,14.787,3.477958438,TRUE
70756,26645,2021-07-29T06:07:34,960369664,02/07/2021 10:12,Meter,25446,26174,728,471,4.6575,3.61168622,TRUE
70757,38472,2021-07-29T06:07:35,423469421,02/07/2021 10:12,Meter,36209,37594,1385,878,9.0045,3.482385791,TRUE
70760,27906,2021-07-29T06:07:35,1497221989,02/07/2021 10:12,Meter,26703,27427,724,479,4.968,3.443466759,TRUE
70825,47442,2021-07-29T06:07:35,155050545,02/07/2021 10:12,Meter,45499,46687,1188,755,9.123,2.955638026,TRUE
70799,67444,2021-07-29T06:07:35,423574396,02/07/2021 10:12,Meter,64427,66270,1843,1174,11.799,3.553569915,TRUE
71134,48386,2021-07-29T06:07:36,1228712711,02/07/2021 10:12,Meter,46400,47672,1272,714,5.76,4.427083333,TRUE
71298,59189,2021-07-29T06:07:36,2034051096,02/07/2021 10:12,Meter,56131,57970,1839,1219,13.338,3.264036159,TRUE
71448,47182,2021-07-29T06:07:36,691883110,02/07/2021 10:12,Meter,45041,46331,1290,851,10.26,2.962266778,TRUE
71471,30508,2021-07-29T06:07:36,1228800643,02/07/2021 10:12,Meter,29136,29955,819,553,4.59,4.302832244,TRUE
71474,24160,2021-07-29T06:07:37,691930287,02/07/2021 10:12,Meter,23153,23758,605,402,4.05,3.544973545,TRUE
71565,66337,2021-07-29T06:07:37,960365712,02/07/2021 10:12,Meter,63408,65196,1788,1141,11.34,3.593474427,TRUE
71567,43184,2021-07-29T06:07:37,2034107659,02/07/2021 10:12,Meter,41238,42432,1194,752,7.02,3.825803826,TRUE
71568,39981,2021-07-29T06:07:37,423495109,02/07/2021 10:12,Meter,38183,39282,1099,699,6.75,3.698412698,TRUE
71576,42265,2021-07-29T06:07:38,1497237303,02/07/2021 10:12,Meter,40503,41501,998,764,8.37,3.25994197,TRUE
71577,24953,2021-07-29T06:07:38,155058943,02/07/2021 10:12,Meter,23782,24497,715,456,4.32,3.76984127,TRUE
71847,60181,2021-07-29T06:07:40,960323228,02/07/2021 10:12,Meter,57900,59280,1380,901,9.504,3.385792448,TRUE
64539,61463,2021-07-29T06:07:40,1497285962,02/07/2021 10:12,Meter,59009,60513,1504,950,9.418,3.602524042,TRUE
71848,47295,2021-07-29T06:07:40,1765611719,02/07/2021 10:12,Meter,45055,46386,1331,909,8.505,3.817082389,TRUE
70341,24104,2021-07-29T06:07:41,1765695699,02/07/2021 10:12,Meter,22964,23660,696,444,4.3605,3.636542336,TRUE
71163,94686,2021-07-29T06:07:41,1765658155,02/07/2021 10:12,Meter,90061,92899,2838,1787,18.392,3.470064624,TRUE
71655,23714,2021-07-29T06:07:41,1765660872,02/07/2021 10:12,Meter,22243,23092,849,622,4.7088,4.717610796,TRUE
71662,33273,2021-07-29T06:07:41,960353115,02/07/2021 10:12,Meter,31659,32652,993,621,6.804,3.259637188,TRUE
71653,29430,2021-07-29T06:07:42,2034057271,02/07/2021 10:12,Meter,28163,28930,767,500,5.3865,3.315166222,TRUE
71758,77901,2021-07-29T06:07:42,1228755936,02/07/2021 10:12,Meter,74386,76505,2119,1396,14.58,3.419557123,TRUE
71927,22015,2021-07-29T06:07:42,2034046897,02/07/2021 10:12,Meter,20772,21512,740,503,5.148,3.48956599,TRUE
71757,56726,2021-07-29T06:07:42,1497223965,02/07/2021 10:12,Meter,53904,55626,1722,1100,10.4895,3.74524184,TRUE
71786,29655,2021-07-29T06:07:43,1765676680,02/07/2021 10:12,Meter,28482,29192,710,463,5.94,2.783790284,TRUE
71905,49624,2021-07-29T06:07:43,1228755195,02/07/2021 10:12,Meter,47445,48726,1281,898,7.56,4.242252457,TRUE
40719,126647,2021-07-29T06:07:43,2033989346,02/07/2021 10:12,Meter,122517,125012,2495,1635,15.876,3.678058525,TRUE
67438,69405,2021-07-29T06:07:43,1228809041,02/07/2021 10:12,Meter,66315,68153,1838,1252,11.97,3.735529299,TRUE
70361,37441,2021-07-29T06:07:49,1765647781,02/07/2021 10:12,Meter,35485,36670,1185,771,7.938,3.468847857,TRUE
71989,68537,2021-07-29T06:07:49,1765669764,02/07/2021 10:12,Meter,65556,67354,1798,1183,11.88,3.556397306,TRUE
71990,39080,2021-07-29T06:07:49,691899659,02/07/2021 10:12,Meter,37385,38419,1034,661,7.938,2.973940899,TRUE
72130,31417,2021-07-29T06:07:50,691906575,02/07/2021 10:12,Meter,29814,30781,967,636,6.201,3.663003663,TRUE
71393,76965,2021-07-29T06:07:50,2034121985,02/07/2021 10:12,Meter,73895,75774,1879,1191,12.15,3.500881834,TRUE
56954,34069,2021-07-29T06:07:50,2034022444,02/07/2021 10:12,Meter,32960,33629,669,440,5.625,2.793650794,TRUE
67603,41221,2021-07-29T06:07:50,423433606,02/07/2021 10:12,Meter,39627,40565,938,656,7.29,3.213795806,TRUE
72385,26190,2021-07-29T06:07:51,423449167,02/07/2021 10:12,Meter,24662,25594,932,596,6.804,3.128411859,TRUE
72258,62551,2021-07-29T06:07:51,2034061717,02/07/2021 10:12,Meter,59814,61437,1623,1114,9.3555,4.252655046,TRUE
72364,51957,2021-07-29T06:07:51,1765619129,02/07/2021 10:12,Meter,49472,50991,1519,966,9.558,3.609541745,TRUE
72150,45512,2021-07-29T06:07:52,155035231,02/07/2021 10:12,Meter,43669,44792,1123,720,6.804,3.779289494,TRUE
72152,77106,2021-07-29T06:07:52,1765747075,02/07/2021 10:12,Meter,74149,75906,1757,1200,11.88,3.607503608,TRUE
72157,32943,2021-07-29T06:07:52,155016459,02/07/2021 10:12,Meter,31522,32379,857,564,5.67,3.552532124,TRUE
72037,123642,2021-07-29T06:07:52,423470903,02/07/2021 10:12,Meter,118706,121711,3005,1931,17.789,3.876793845,TRUE
72380,27092,2021-07-29T06:07:53,960228133,02/07/2021 10:12,Meter,26089,26646,557,446,8.1,1.9664903,TRUE
72381,44731,2021-07-29T06:07:53,155010037,02/07/2021 10:12,Meter,43479,44251,772,480,8.1,2.116402116,TRUE
72389,36936,2021-07-29T06:07:53,960351139,02/07/2021 10:12,Meter,35528,36389,861,547,8.5347,2.288974924,TRUE
72427,61413,2021-07-29T06:07:53,1228802372,02/07/2021 10:12,Meter,58762,60385,1623,1028,11.178,3.284512946,TRUE
72435,40861,2021-07-29T06:07:53,1497236562,02/07/2021 10:12,Meter,39322,40291,969,570,6.48,3.141534392,TRUE
72478,32640,2021-07-29T06:07:54,2034085923,02/07/2021 10:12,Meter,30825,31929,1104,711,7.9461,3.195637752,TRUE
72481,21928,2021-07-29T06:07:54,1228877213,02/07/2021 10:12,Meter,20886,21529,643,399,4.4145,3.227998641,TRUE
72502,59373,2021-07-29T06:07:54,423470409,02/07/2021 10:12,Meter,56433,58222,1789,1151,11.4777,3.581479117,TRUE
72503,32302,2021-07-29T06:07:54,1497221248,02/07/2021 10:12,Meter,30799,31709,910,593,7.3575,2.878501044,TRUE
72527,163189,2021-07-29T06:07:55,2034094074,02/07/2021 10:12,Meter,155959,160383,4424,2806,27.405,3.656788386,TRUE
72441,43118,2021-07-29T06:07:55,960441788,02/07/2021 10:12,Meter,40778,42185,1407,933,9.315,3.577179664,TRUE
72407,107148,2021-07-29T06:07:55,691930040,02/07/2021 10:12,Meter,102446,105376,2930,1772,20.52,3.084099137,TRUE
72406,50221,2021-07-29T06:07:55,155059931,02/07/2021 10:12,Meter,47946,49326,1380,895,8.64,3.699570106,TRUE
72397,41649,2021-07-29T06:07:56,423494862,02/07/2021 10:12,Meter,39746,40867,1121,782,6.75,4.137566138,TRUE
72576,33106,2021-07-29T06:07:56,960365959,02/07/2021 10:12,Meter,31507,32484,977,622,5.67,3.917863442,TRUE
72464,56305,2021-07-29T06:07:56,1228801384,02/07/2021 10:12,Meter,53594,55269,1675,1036,10.8,3.425925926,TRUE
65765,30831,2021-07-29T06:07:56,960326933,02/07/2021 10:12,Meter,29661,30367,706,464,4.374,3.788621073,TRUE
67623,51095,2021-07-29T06:07:57,423433112,02/07/2021 10:12,Meter,47546,50184,2638,911,8.748,3.719217454,TRUE
65742,33292,2021-07-29T06:07:57,1228667263,02/07/2021 10:12,Meter,32077,32817,740,475,5.85,2.8998779,TRUE
53785,32650,2021-07-29T06:07:57,2033969339,02/07/2021 10:12,Meter,31749,32293,544,357,5.886,2.166156983,TRUE
72556,52462,2021-07-29T06:07:58,1228779648,02/07/2021 10:12,Meter,49997,51492,1495,970,10.0062,3.462139188,TRUE
72593,66005,2021-07-29T06:07:58,154952733,02/07/2021 10:12,Meter,61407,64713,3306,1292,11.4777,4.020218087,TRUE
72624,53418,2021-07-29T06:07:58,1765615671,02/07/2021 10:12,Meter,51018,52474,1456,944,10.206,3.303378965,TRUE
72651,39040,2021-07-29T06:07:58,1497260274,02/07/2021 10:12,Meter,37257,38341,1084,699,6.48,3.852513228,TRUE
72668,39559,2021-07-29T06:07:59,1228781871,02/07/2021 10:12,Meter,37968,38909,941,650,5.76,4.030257937,TRUE
72681,92232,2021-07-29T06:07:59,1228785823,02/07/2021 10:12,Meter,88452,90741,2289,1491,13.5675,3.924820343,TRUE
72699,46313,2021-07-29T06:07:59,691944860,02/07/2021 10:12,Meter,43919,45385,1466,928,10.8675,3.049722304,TRUE
29177,23118,2021-07-29T06:07:59,2033968104,02/07/2021 10:12,Meter,21999,22669,670,449,4.05,3.959435626,TRUE
57325,102441,2021-07-29T06:08:00,423490169,02/07/2021 10:12,Meter,98502,100895,2393,1546,15.3036,3.60792792,TRUE
72401,60577,2021-07-29T06:08:00,1228773967,02/07/2021 10:12,Meter,58193,59677,1484,900,7.02,4.578754579,TRUE
51968,21610,2021-07-29T06:08:06,1497252864,02/07/2021 10:13,Meter,20847,21315,468,295,3.848,2.737971488,TRUE
67614,49760,2021-07-29T06:08:06,423473620,02/07/2021 10:13,Meter,47487,48886,1399,874,9.792,3.187733427,TRUE
72428,35870,2021-07-29T06:08:06,423510670,02/07/2021 10:13,Meter,33956,35089,1133,781,6.4746,4.308043299,TRUE
72614,66470,2021-07-29T06:08:06,1497217296,02/07/2021 10:13,Meter,63682,65335,1653,1135,11.178,3.626383457,TRUE
70928,66779,2021-07-29T06:08:07,1228779154,02/07/2021 10:13,Meter,64001,65661,1660,1118,10.8675,3.674126655,TRUE
54711,28572,2021-07-29T06:08:07,1765654697,02/07/2021 10:13,Meter,27485,28138,653,434,4.32,3.587962963,TRUE
62601,22054,2021-07-29T06:08:07,1765672481,02/07/2021 10:13,Meter,21122,21690,568,364,3.51,3.703703704,TRUE
61122,39703,2021-07-29T06:08:07,155059437,02/07/2021 10:13,Meter,37599,38915,1316,788,8.64,3.257275132,TRUE
54087,33061,2021-07-29T06:08:08,1228805336,02/07/2021 10:13,Meter,31698,32532,834,529,5.13,3.682818157,TRUE
64582,32629,2021-07-29T06:08:08,960304209,02/07/2021 10:13,Meter,31225,32074,849,555,5.4,3.670634921,TRUE
62778,45908,2021-07-29T06:08:08,155038689,02/07/2021 10:13,Meter,43774,45075,1301,833,9.36,3.178418803,TRUE
55787,55632,2021-07-29T06:08:08,1765622587,02/07/2021 10:13,Meter,53658,54868,1210,764,8.168,3.340562474,TRUE
67856,55625,2021-07-29T06:08:09,2034174349,02/07/2021 10:13,Meter,53502,54805,1303,820,9.72,3.012933568,TRUE
71884,43683,2021-07-29T06:08:09,2034062211,02/07/2021 10:13,Meter,41658,42875,1217,808,9.45,3.053665911,TRUE
53954,68063,2021-07-29T06:08:09,691823336,02/07/2021 10:13,Meter,65626,67042,1416,1021,9.072,4.019431847,TRUE
4489,29375,2021-07-29T06:08:09,960320264,02/07/2021 10:13,Meter,28291,28942,651,433,4.752,3.254268879,TRUE
4389,24584,2021-07-29T06:08:10,691886074,02/07/2021 10:13,Meter,23521,24164,643,420,4.32,3.472222222,TRUE
4455,21651,2021-07-29T06:08:10,155013248,02/07/2021 10:13,Meter,20691,21277,586,374,3.888,3.43547913,TRUE
64599,44305,2021-07-29T06:08:10,960383249,02/07/2021 10:13,Meter,42160,43499,1339,806,9.045,3.182500197,TRUE
51970,42160,2021-07-29T06:08:10,691917443,02/07/2021 10:13,Meter,40053,41342,1289,818,10.584,2.760231077,TRUE
45788,71884,2021-07-29T06:08:11,2034123467,02/07/2021 10:13,Meter,69035,70736,1701,1148,10.206,4.017244758,TRUE
29079,73056,2021-07-29T06:08:11,423378772,02/07/2021 10:13,Meter,70451,71992,1541,1064,11.543,3.292038465,TRUE
67977,15861,2021-07-29T06:08:11,2034249931,02/07/2021 10:13,Meter,15094,15556,462,305,5.5575,1.960028276,TRUE
71728,28695,2021-07-29T06:08:17,960227886,02/07/2021 10:13,Meter,27120,28068,948,627,6.21,3.605935128,TRUE
71660,47063,2021-07-29T06:08:17,423450649,02/07/2021 10:13,Meter,44775,46144,1369,919,9.936,3.303283874,TRUE
73901,112682,2021-07-29T06:08:18,1497216802,02/07/2021 10:13,Meter,107813,110777,2964,1905,13.824,4.92156498,TRUE
73954,54749,2021-07-29T06:08:18,1765616165,02/07/2021 10:13,Meter,51897,53633,1736,1116,10.08,3.954081633,TRUE
73819,26795,2021-07-29T06:08:18,423516351,02/07/2021 10:13,Meter,25670,26328,658,467,3.9195,4.255280375,TRUE
72424,49404,2021-07-29T06:08:18,1765732749,02/07/2021 10:13,Meter,46929,48456,1527,948,9.936,3.407522429,TRUE
74104,52223,2021-07-29T06:08:18,691903364,02/07/2021 10:13,Meter,49698,51235,1537,988,10.08,3.500566893,TRUE
67801,59306,2021-07-29T06:08:19,1765647040,02/07/2021 10:13,Meter,56596,58246,1650,1060,12.0555,3.140238303,TRUE
74000,33194,2021-07-29T06:08:19,1497180987,02/07/2021 10:13,Meter,31893,32674,781,520,5.76,3.224206349,TRUE
73482,47257,2021-07-29T06:08:19,1497227423,02/07/2021 10:13,Meter,44838,46305,1467,952,9.315,3.650026838,TRUE
72903,56590,2021-07-29T06:08:20,960380038,02/07/2021 10:13,Meter,53682,55480,1798,1110,11.178,3.54650717,TRUE
73832,22086,2021-07-29T06:08:20,691874465,02/07/2021 10:13,Meter,21144,21718,574,368,4.608,2.85218254,TRUE
73737,48687,2021-07-29T06:08:20,691954246,02/07/2021 10:13,Meter,46271,47740,1469,947,9.072,3.728111615,TRUE
73603,46780,2021-07-29T06:08:20,960387201,02/07/2021 10:13,Meter,44750,46004,1254,776,6.264,4.424375114,TRUE
74742,36380,2021-07-29T06:08:21,960327427,02/07/2021 10:13,Meter,34863,35795,932,585,5.4,3.869047619,TRUE
74860,41968,2021-07-29T06:08:21,155046346,02/07/2021 10:13,Meter,40129,41222,1093,746,7.236,3.681986891,TRUE
73822,38435,2021-07-29T06:08:21,1497225694,02/07/2021 10:13,Meter,36238,37536,1298,899,8.073,3.977101803,TRUE
69278,37961,2021-07-29T06:08:22,155011519,02/07/2021 10:13,Meter,36419,37317,898,644,5.544,4.148629149,TRUE
72367,34553,2021-07-29T06:08:22,1497198277,02/07/2021 10:13,Meter,33058,33954,896,599,5.247,4.077159738,TRUE
82373,35353,2021-07-29T06:08:22,692066384,02/07/2021 10:13,Meter,33295,34492,1197,861,9.072,3.389550265,TRUE
74655,142007,2021-07-29T06:08:23,1228786811,02/07/2021 10:13,Meter,136118,139624,3506,2383,22.3668,3.805065671,TRUE
74872,27983,2021-07-29T06:08:23,1765630491,02/07/2021 10:13,Meter,26733,27473,740,510,4.824,3.775764037,TRUE
74466,70711,2021-07-29T06:08:23,960343729,02/07/2021 10:13,Meter,67818,69511,1693,1200,10.944,3.9160401,TRUE
74633,73933,2021-07-29T06:08:24,423510176,02/07/2021 10:13,Meter,70993,72709,1716,1224,11.52,3.794642857,TRUE
73502,73851,2021-07-29T06:08:24,1497251629,02/07/2021 10:13,Meter,70182,72420,2238,1431,20.736,2.464657738,TRUE
70275,59992,2021-07-29T06:08:24,423413105,02/07/2021 10:13,Meter,57583,59028,1445,964,9.414,3.657167137,TRUE
74772,53756,2021-07-29T06:08:24,1497222730,02/07/2021 10:13,Meter,52208,53129,921,627,9.45,2.369614512,TRUE
72365,58368,2021-07-29T06:08:25,960283955,02/07/2021 10:13,Meter,55870,57389,1519,979,10.595,3.300074159,TRUE
74250,36639,2021-07-29T06:08:25,960370652,02/07/2021 10:13,Meter,35164,36060,896,579,6.624,3.12176501,TRUE
72997,34651,2021-07-29T06:08:25,1497140726,02/07/2021 10:13,Meter,32841,33935,1094,716,7.236,3.533917713,TRUE
73107,35524,2021-07-29T06:08:26,155014977,02/07/2021 10:13,Meter,33734,34854,1120,670,8.3835,2.85424601,TRUE
72991,32822,2021-07-29T06:08:26,1228756430,02/07/2021 10:13,Meter,30918,32100,1182,722,7.452,3.460240779,TRUE
72989,29807,2021-07-29T06:08:26,691934733,02/07/2021 10:13,Meter,28387,29251,864,556,5.2785,3.76189123,TRUE
73914,36472,2021-07-29T06:08:27,155013989,02/07/2021 10:13,Meter,34470,35694,1224,778,8.694,3.195964376,TRUE
73000,37572,2021-07-29T06:08:27,1765633702,02/07/2021 10:13,Meter,35953,36932,979,640,6.03,3.790570955,TRUE
72988,31003,2021-07-29T06:08:27,960326686,02/07/2021 10:13,Meter,29516,30423,907,580,5.729,3.615689599,TRUE
69274,58001,2021-07-29T06:08:28,423469915,02/07/2021 10:13,Meter,55586,57056,1470,945,8.694,3.881987578,TRUE
72993,41978,2021-07-29T06:08:28,2034054554,02/07/2021 10:13,Meter,40276,41315,1039,663,7.7625,3.050379572,TRUE
69288,43999,2021-07-29T06:08:28,1497215320,02/07/2021 10:13,Meter,41792,43136,1344,863,8.141,3.785951182,TRUE
74386,41936,2021-07-29T06:08:28,691892002,02/07/2021 10:14,Meter,39974,41162,1188,774,7.839,3.526324422,TRUE
72986,33458,2021-07-29T06:08:28,2034064681,02/07/2021 10:14,Meter,32060,32902,842,556,5.589,3.552897273,TRUE
72094,30870,2021-07-29T06:08:29,1228779401,02/07/2021 10:14,Meter,29385,30288,903,582,6.21,3.347135956,TRUE
73731,43672,2021-07-29T06:08:29,960387448,02/07/2021 10:14,Meter,41502,42837,1335,835,10.0062,2.980295074,TRUE
72802,82091,2021-07-29T06:08:29,423502025,02/07/2021 10:14,Meter,78799,80851,2052,1240,10.44,4.241926656,TRUE
72402,39232,2021-07-29T06:08:29,960327180,02/07/2021 10:14,Meter,37330,38502,1172,730,6.48,4.023368607,TRUE
72995,54368,2021-07-29T06:08:30,2034076784,02/07/2021 10:14,Meter,51975,53424,1449,944,8.694,3.877879654,TRUE
74119,60144,2021-07-29T06:08:30,691945354,02/07/2021 10:14,Meter,57302,59033,1731,1111,10.5948,3.745098674,TRUE
72695,51444,2021-07-29T06:08:30,155003862,02/07/2021 10:14,Meter,49129,50541,1412,903,9.4176,3.424439348,TRUE
71716,33844,2021-07-29T06:08:30,960313101,02/07/2021 10:14,Meter,32600,33354,754,490,5.76,3.038194444,TRUE
72987,63274,2021-07-29T06:08:31,2034128901,02/07/2021 10:14,Meter,60229,62090,1861,1184,12.1095,3.491945521,TRUE
74512,94957,2021-07-29T06:08:31,423509929,02/07/2021 10:14,Meter,91599,93843,2244,1114,15.552,2.558237801,TRUE
73540,48092,2021-07-29T06:08:31,2034053813,02/07/2021 10:14,Meter,46262,47337,1075,755,7.3125,3.687423687,TRUE
73971,61452,2021-07-29T06:08:32,691873971,02/07/2021 10:14,Meter,58691,60381,1690,1071,11.34,3.373015873,TRUE
73305,63578,2021-07-29T06:08:32,1228797185,02/07/2021 10:14,Meter,60825,62491,1666,1087,10.773,3.603585684,TRUE
73372,31382,2021-07-29T06:08:32,1497193090,02/07/2021 10:14,Meter,29949,30839,890,543,5.954,3.257114065,TRUE
73374,44043,2021-07-29T06:08:32,960322981,02/07/2021 10:14,Meter,42278,43340,1062,703,6.804,3.690056269,TRUE
73376,63709,2021-07-29T06:08:33,155046593,02/07/2021 10:14,Meter,60690,62513,1823,1196,13.3245,3.205695202,TRUE
72352,87084,2021-07-29T06:08:33,2034180030,02/07/2021 10:14,Meter,82392,85182,2790,1902,16.7751,4.04936909,TRUE
72372,135883,2021-07-29T06:08:33,691910527,02/07/2021 10:14,Meter,130933,134233,3300,1650,25.604,2.301537706,TRUE
64641,82341,2021-07-29T06:08:33,2034086170,02/07/2021 10:14,Meter,78967,81001,2034,1340,13.23,3.617319944,TRUE
72984,53795,2021-07-29T06:08:34,960335331,02/07/2021 10:14,Meter,51477,52880,1403,915,8.694,3.758749877,TRUE
72985,46826,2021-07-29T06:08:34,1228755442,02/07/2021 10:14,Meter,44746,45999,1253,827,7.7625,3.804922935,TRUE
72854,38128,2021-07-29T06:08:34,2034052084,02/07/2021 10:14,Meter,35992,37302,1310,826,9.4176,3.132432892,TRUE
73432,75061,2021-07-29T06:08:36,691947083,02/07/2021 10:14,Meter,71551,73641,2090,1420,13.392,3.786909029,TRUE
73887,40895,2021-07-29T06:08:37,155082161,02/07/2021 10:14,Meter,39214,40235,1021,660,7.128,3.306878307,TRUE
86016,38426,2021-07-29T06:08:37,1228819662,02/07/2021 10:14,Meter,36158,37544,1386,882,9.3465,3.370245546,TRUE
73328,41404,2021-07-29T06:08:37,423443980,02/07/2021 10:14,Meter,39768,40807,1039,597,6.21,3.433402346,TRUE
74383,25331,2021-07-29T06:08:39,691887803,02/07/2021 10:14,Meter,24043,24830,787,501,4.968,3.601621808,TRUE
74946,57789,2021-07-29T06:08:39,423441510,02/07/2021 10:14,Meter,55202,56855,1653,934,11.52,2.895585317,TRUE
72741,62012,2021-07-29T06:08:39,1497185680,02/07/2021 10:14,Meter,59097,60871,1774,1141,14.283,2.853042078,TRUE
72747,61224,2021-07-29T06:08:39,960320511,02/07/2021 10:14,Meter,58767,60260,1493,964,9.3465,3.683579033,TRUE
74610,61643,2021-07-29T06:08:40,1765617400,02/07/2021 10:14,Meter,59072,60605,1533,1038,10.5948,3.499021083,TRUE
75180,30561,2021-07-29T06:08:40,155133784,02/07/2021 10:14,Meter,29666,30211,545,350,7.2,1.736111111,TRUE
75176,33943,2021-07-29T06:08:40,2034102966,02/07/2021 10:14,Meter,32003,33177,1174,766,8.2215,3.327512359,TRUE
75166,24423,2021-07-29T06:08:40,155044864,02/07/2021 10:14,Meter,23425,24038,613,385,4.5225,3.040353787,TRUE
75161,43933,2021-07-29T06:08:41,155120199,02/07/2021 10:14,Meter,40774,43045,2271,888,8.2215,3.85748169,TRUE
72114,57062,2021-07-29T06:08:41,691913985,02/07/2021 10:14,Meter,54789,56164,1375,898,8.505,3.770891072,TRUE
74858,37423,2021-07-29T06:08:41,691891755,02/07/2021 10:14,Meter,35725,36763,1038,660,5.4,4.365079365,TRUE
74568,76097,2021-07-29T06:08:41,2033989593,02/07/2021 10:14,Meter,72869,74796,1927,1301,11.925,3.896376161,TRUE
73743,49897,2021-07-29T06:08:42,691885086,02/07/2021 10:14,Meter,47146,48764,1618,1133,10.017,4.039561317,TRUE
70575,34238,2021-07-29T06:08:42,423434347,02/07/2021 10:14,Meter,32753,33659,906,579,7.0875,2.917611489,TRUE
73323,19716,2021-07-29T06:08:42,960304456,02/07/2021 10:14,Meter,18702,19328,626,388,5.13,2.701197438,TRUE
55771,48529,2021-07-29T06:08:42,1228905371,02/07/2021 10:14,Meter,46349,47709,1360,820,8.208,3.567947647,TRUE
75907,92629,2021-07-29T06:08:43,691840873,02/07/2021 10:14,Meter,88753,91065,2312,1564,17.01,3.283782649,TRUE
69803,37653,2021-07-29T06:08:43,423470162,02/07/2021 10:14,Meter,36522,37111,589,542,7.155,2.705400819,TRUE
69789,29137,2021-07-29T06:08:43,1765651486,02/07/2021 10:14,Meter,27915,28652,737,485,4.2525,4.073234232,TRUE
72729,55020,2021-07-29T06:08:43,155129338,02/07/2021 10:14,Meter,52782,54135,1353,885,9.045,3.494432599,TRUE
46276,30566,2021-07-29T06:08:44,2034063199,02/07/2021 10:14,Meter,29468,30138,670,428,4.536,3.369866465,TRUE
75237,61342,2021-07-29T06:08:44,1765734231,02/07/2021 10:14,Meter,53685,60224,6539,1118,11.457,3.485080861,TRUE
72804,41281,2021-07-29T06:08:44,1228756924,02/07/2021 10:14,Meter,38994,40391,1397,890,10.971,2.89724859,TRUE
37045,59828,2021-07-29T06:08:44,2033987123,02/07/2021 10:14,Meter,57993,59032,1039,796,7.056,4.028992549,TRUE
72606,40456,2021-07-29T06:08:45,1497192843,02/07/2021 10:14,Meter,38806,39801,995,655,6.336,3.692054473,TRUE
75210,30449,2021-07-29T06:08:45,2034085676,02/07/2021 10:14,Meter,29003,29901,898,548,8.748,2.237246064,TRUE
75220,46993,2021-07-29T06:08:45,423475596,02/07/2021 10:14,Meter,45125,46250,1125,743,8.064,3.290639172,TRUE
75348,109409,2021-07-29T06:08:45,1765678409,02/07/2021 10:14,Meter,104666,107472,2806,1937,17.28,4.00338955,TRUE
75421,29564,2021-07-29T06:08:46,155020905,02/07/2021 10:14,Meter,28207,29034,827,530,6.21,3.048079135,TRUE
75426,22557,2021-07-29T06:08:46,1765649757,02/07/2021 10:14,Meter,21514,22158,644,399,4.221,3.375977257,TRUE
75434,41103,2021-07-29T06:08:46,2034091604,02/07/2021 10:14,Meter,39143,40338,1195,765,8.3835,3.258952534,TRUE
75502,59973,2021-07-29T06:08:46,155037701,02/07/2021 10:14,Meter,57282,58880,1598,1093,10.8675,3.591968188,TRUE
55234,61287,2021-07-29T06:08:47,1497237056,02/07/2021 10:14,Meter,58960,60306,1346,981,7.56,4.634353741,TRUE
78355,42598,2021-07-29T06:08:47,1497235080,02/07/2021 10:14,Meter,40022,41610,1588,988,10.044,3.513113728,TRUE
75269,26389,2021-07-29T06:08:47,1228756677,02/07/2021 10:14,Meter,25036,25862,826,527,5.13,3.668894458,TRUE
47171,88855,2021-07-29T06:08:47,423609717,02/07/2021 10:14,Meter,85605,87471,1866,1384,11.0295,4.481487958,TRUE
66401,25037,2021-07-29T06:08:48,2034124208,02/07/2021 10:14,Meter,23809,24538,729,499,7.371,2.417776227,TRUE
75604,55739,2021-07-29T06:08:48,1765667047,02/07/2021 10:14,Meter,53210,54713,1503,1026,6.156,5.952380952,TRUE
75605,53185,2021-07-29T06:08:48,1765617153,02/07/2021 10:14,Meter,50822,52239,1417,946,6.48,5.213844797,TRUE
75366,30917,2021-07-29T06:08:49,1497242737,02/07/2021 10:14,Meter,29627,30409,782,508,5.13,3.536619326,TRUE
75585,32883,2021-07-29T06:08:49,423495356,02/07/2021 10:14,Meter,31132,32200,1068,683,5.7645,4.231565121,TRUE
74237,18605,2021-07-29T06:08:49,423480783,02/07/2021 10:14,Meter,17776,18283,507,322,3.24,3.549382716,TRUE
74415,87424,2021-07-29T06:08:49,423517833,02/07/2021 10:14,Meter,83594,85852,2258,1572,13.869,4.048082569,TRUE
74680,90973,2021-07-29T06:08:50,1765631973,02/07/2021 10:14,Meter,86899,89401,2502,1572,12.69,4.42418102,TRUE
74932,39379,2021-07-29T06:08:50,423448920,02/07/2021 10:14,Meter,37637,38698,1061,681,6.48,3.753306878,TRUE
75668,29037,2021-07-29T06:08:51,2034183488,02/07/2021 10:14,Meter,27840,28560,720,477,5.184,3.286210317,TRUE
76575,32950,2021-07-29T06:08:53,2034083206,02/07/2021 10:14,Meter,31642,32420,778,530,5.0031,3.783368597,TRUE
72253,53815,2021-07-29T06:08:55,423542780,02/07/2021 10:14,Meter,51272,52805,1533,1010,8.829,4.08556219,TRUE
76027,55179,2021-07-29T06:08:55,1765596405,02/07/2021 10:14,Meter,52396,54069,1673,1110,12.0555,3.288362751,TRUE
23879,42134,2021-07-29T06:08:55,154946064,02/07/2021 10:14,Meter,40776,41559,783,575,5.796,3.5430839,TRUE
85495,38713,2021-07-29T06:08:55,2034303283,02/07/2021 10:15,Meter,34710,37152,2442,1561,14.472,3.852266446,TRUE
76524,38880,2021-07-29T06:08:56,960321993,02/07/2021 10:15,Meter,36991,38153,1162,727,5.4,4.808201058,TRUE
75894,37989,2021-07-29T06:08:57,423455836,02/07/2021 10:15,Meter,35637,37071,1434,918,9.72,3.373015873,TRUE
76627,23371,2021-07-29T06:08:57,1765638148,02/07/2021 10:15,Meter,22298,22951,653,420,5.67,2.645502646,TRUE
76578,86950,2021-07-29T06:08:58,1765612707,02/07/2021 10:15,Meter,82676,85286,2610,1664,15.552,3.821281599,TRUE
69174,77103,2021-07-29T06:08:59,1228786564,02/07/2021 10:15,Meter,73443,75595,2152,1508,14.31,3.763601877,TRUE
74544,44227,2021-07-29T06:08:59,1497197536,02/07/2021 10:15,Meter,41990,43327,1337,900,9.072,3.5430839,TRUE
76404,43124,2021-07-29T06:08:59,1765650004,02/07/2021 10:15,Meter,40963,42266,1303,858,10.5948,2.892254421,TRUE
76390,47130,2021-07-29T06:08:59,960344223,02/07/2021 10:15,Meter,45046,46292,1246,838,8.3835,3.569937547,TRUE
76626,94612,2021-07-29T06:09:00,2034087652,02/07/2021 10:15,Meter,90718,93043,2325,1569,14.472,3.872009003,TRUE
75893,36113,2021-07-29T06:09:00,155074751,02/07/2021 10:15,Meter,34582,35494,912,619,5.832,3.790662355,TRUE
78952,49134,2021-07-29T06:09:00,423705059,02/07/2021 10:15,Meter,46624,48095,1471,1039,8.1405,4.558337062,TRUE
75638,56322,2021-07-29T06:09:01,691885827,02/07/2021 10:15,Meter,53485,55166,1681,1156,11.61,3.556047742,TRUE
75681,53968,2021-07-29T06:09:01,155025351,02/07/2021 10:15,Meter,51265,52898,1633,1070,10.773,3.547227858,TRUE
45488,51789,2021-07-29T06:09:01,1497234833,02/07/2021 10:15,Meter,50126,51101,975,688,6.21,3.956751783,TRUE
76643,275197,2021-07-29T06:09:01,1765611472,02/07/2021 10:15,Meter,262487,270351,7864,4846,32.94,5.25414173,TRUE
75707,14991,2021-07-29T06:09:02,423555871,02/07/2021 10:15,Meter,14323,14727,404,264,3.24,2.91005291,TRUE
75246,25128,2021-07-29T06:09:02,423558588,02/07/2021 10:15,Meter,23928,24659,731,469,4.658,3.595963933,TRUE
75837,28176,2021-07-29T06:09:04,2034051590,02/07/2021 10:15,Meter,27130,27728,598,448,4.536,3.527336861,TRUE
75705,53638,2021-07-29T06:09:04,691887062,02/07/2021 10:15,Meter,51235,52684,1449,954,9.072,3.755668934,TRUE
74051,36196,2021-07-29T06:09:04,423469174,02/07/2021 10:15,Meter,34694,35679,985,517,7.371,2.5049906,TRUE
75846,52908,2021-07-29T06:09:05,691875700,02/07/2021 10:15,Meter,50455,51890,1435,1018,9.18,3.960473078,TRUE
57791,22708,2021-07-29T06:09:05,691979687,02/07/2021 10:15,Meter,21973,22434,461,274,3.825,2.558356676,TRUE
52080,42190,2021-07-29T06:09:05,155012507,02/07/2021 10:15,Meter,40830,41635,805,555,5.4,3.670634921,TRUE
76344,22977,2021-07-29T06:09:06,1497250147,02/07/2021 10:15,Meter,22005,22585,580,392,4.5225,3.095632946,TRUE
74938,83695,2021-07-29T06:09:06,1765657414,02/07/2021 10:15,Meter,79455,82053,2598,1642,16.4808,3.558253067,TRUE
73512,46988,2021-07-29T06:09:06,423501284,02/07/2021 10:15,Meter,44884,46271,1387,717,7.7625,3.298826777,TRUE
75710,62661,2021-07-29T06:09:07,960351386,02/07/2021 10:15,Meter,59600,61462,1862,1199,11.907,3.596323891,TRUE
76011,38583,2021-07-29T06:09:07,691991296,02/07/2021 10:15,Meter,36671,37850,1179,733,7.371,3.551563075,TRUE
76844,72240,2021-07-29T06:09:08,2034048132,02/07/2021 10:15,Meter,69260,71059,1799,1181,10.553,3.996832316,TRUE
76845,65068,2021-07-29T06:09:08,1765626786,02/07/2021 10:15,Meter,62001,63878,1877,1190,13.266,3.203678577,TRUE
18648,77278,2021-07-29T06:09:08,423393098,02/07/2021 10:15,Meter,74722,76257,1535,1021,5.94,6.138768639,TRUE
37560,54980,2021-07-29T06:09:08,2034106177,02/07/2021 10:15,Meter,53234,54308,1074,672,6.48,3.703703704,TRUE
77003,23789,2021-07-29T06:09:09,960353856,02/07/2021 10:15,Meter,22734,23373,639,416,3.726,3.987424277,TRUE
72829,49032,2021-07-29T06:09:09,1228806077,02/07/2021 10:15,Meter,46848,48219,1371,813,11.03,2.632431032,TRUE
71397,31765,2021-07-29T06:09:09,691903858,02/07/2021 10:15,Meter,30169,31159,990,606,6.156,3.515733779,TRUE
66096,56661,2021-07-29T06:09:09,960346693,02/07/2021 10:15,Meter,54563,55837,1274,824,6.48,4.541446208,TRUE
77687,47722,2021-07-29T06:09:10,1228814722,02/07/2021 10:15,Meter,45006,46612,1606,1110,10.044,3.946919269,TRUE
71391,44170,2021-07-29T06:09:10,960388683,02/07/2021 10:15,Meter,42400,43489,1089,681,6.156,3.950849346,TRUE
72870,29174,2021-07-29T06:09:10,691899165,02/07/2021 10:15,Meter,27623,28578,955,596,6.21,3.427651254,TRUE
77225,42575,2021-07-29T06:09:11,1228818180,02/07/2021 10:15,Meter,40547,41743,1196,832,7.776,3.821281599,TRUE
69625,40391,2021-07-29T06:09:12,1497210133,02/07/2021 10:15,Meter,38855,39778,923,613,6.48,3.378527337,TRUE
77293,59318,2021-07-29T06:09:13,2034098767,02/07/2021 10:15,Meter,56170,58091,1921,1227,11.34,3.864323507,TRUE
77386,53345,2021-07-29T06:09:13,1765545029,02/07/2021 10:15,Meter,50987,52426,1439,919,9.936,3.303283874,TRUE
93285,49278,2021-07-29T06:09:13,2034341321,02/07/2021 10:15,Meter,45588,47724,2136,1554,20.619,2.691692129,TRUE
77500,63292,2021-07-29T06:09:14,1228824108,02/07/2021 10:15,Meter,60315,62094,1779,1198,11.489,3.724059038,TRUE
77528,58627,2021-07-29T06:09:14,2034122232,02/07/2021 10:15,Meter,55701,57437,1736,1190,10.854,3.915607149,TRUE
77494,20882,2021-07-29T06:09:14,691854705,02/07/2021 10:15,Meter,19984,20507,523,375,4.32,3.100198413,TRUE
75876,68366,2021-07-29T06:09:14,1765687054,02/07/2021 10:15,Meter,65673,67296,1623,1070,10.5525,3.621349037,TRUE
73602,41052,2021-07-29T06:09:16,1497219025,02/07/2021 10:15,Meter,39497,40405,908,647,6.156,3.753596955,TRUE
76389,30605,2021-07-29T06:09:17,960256538,02/07/2021 10:15,Meter,29202,29994,792,611,4.86,4.490005879,TRUE
75429,62179,2021-07-29T06:09:17,2034063446,02/07/2021 10:15,Meter,59033,60929,1896,1250,11.448,3.899620645,TRUE
67608,32466,2021-07-29T06:09:17,423446944,02/07/2021 10:15,Meter,31122,31932,810,534,4.77,3.998203055,TRUE
80460,48101,2021-07-29T06:09:18,155075986,02/07/2021 10:15,Meter,46047,47380,1333,721,9.072,2.83840388,TRUE
77558,20661,2021-07-29T06:09:18,423501531,02/07/2021 10:15,Meter,19730,20290,560,371,4.104,3.228557505,TRUE
78680,37069,2021-07-29T06:09:18,1228760876,02/07/2021 10:15,Meter,35455,36448,993,621,5.832,3.802910053,TRUE
78657,32239,2021-07-29T06:09:18,960289636,02/07/2021 10:15,Meter,30395,31506,1111,733,7.056,3.710114998,TRUE
72943,83540,2021-07-29T06:09:19,1228966133,02/07/2021 10:15,Meter,80664,82407,1743,1133,10.935,3.700437651,TRUE
78630,21281,2021-07-29T06:09:19,691954740,02/07/2021 10:15,Meter,20113,20825,712,456,4.536,3.590325019,TRUE
78628,21967,2021-07-29T06:09:19,691928558,02/07/2021 10:15,Meter,21394,21729,335,238,4.5,1.888888889,TRUE
78547,41132,2021-07-29T06:09:19,960383002,02/07/2021 10:15,Meter,39224,40393,1169,739,9.216,2.863808284,TRUE
78513,44297,2021-07-29T06:09:20,1228725061,02/07/2021 10:15,Meter,42063,43434,1371,863,10.692,2.882662605,TRUE
78478,47028,2021-07-29T06:09:20,2034104942,02/07/2021 10:15,Meter,44773,46126,1353,902,7.776,4.142783657,TRUE
78448,65190,2021-07-29T06:09:20,423485476,02/07/2021 10:15,Meter,61901,63891,1990,1299,11.799,3.931931277,TRUE
78319,73839,2021-07-29T06:09:20,960382261,02/07/2021 10:15,Meter,70546,72514,1968,1325,12.06,3.923833215,TRUE
78172,61675,2021-07-29T06:09:21,423519315,02/07/2021 10:15,Meter,58922,60551,1629,1124,9.72,4.129923574,TRUE
77905,74940,2021-07-29T06:09:21,1497193337,02/07/2021 10:15,Meter,71733,73638,1905,1302,11.448,4.061844864,TRUE
78708,30775,2021-07-29T06:09:21,154982126,02/07/2021 10:15,Meter,29008,30041,1033,734,6.804,3.852775678,TRUE
78667,28806,2021-07-29T06:09:21,1765607026,02/07/2021 10:15,Meter,27352,28235,883,571,5.76,3.540426587,TRUE
78519,35279,2021-07-29T06:09:22,691943872,02/07/2021 10:15,Meter,33847,34700,853,579,6.156,3.359092175,TRUE
78374,48642,2021-07-29T06:09:22,1228849549,02/07/2021 10:15,Meter,46432,47783,1351,859,9.747,3.147488605,TRUE
78318,48290,2021-07-29T06:09:22,1497196301,02/07/2021 10:15,Meter,46173,47431,1258,859,8.1,3.787477954,TRUE
75712,30836,2021-07-29T06:09:23,423419527,02/07/2021 10:16,Meter,29633,30332,699,504,5.472,3.289473684,TRUE
78075,33252,2021-07-29T06:09:23,1228825343,02/07/2021 10:16,Meter,30716,32566,1850,686,9.36,2.617521368,TRUE
72645,51920,2021-07-29T06:09:23,691869031,02/07/2021 10:16,Meter,49414,50945,1531,975,9.792,3.556109944,TRUE
78072,83496,2021-07-29T06:09:23,2034045662,02/07/2021 10:16,Meter,80039,82119,2080,1377,17.01,2.891156463,TRUE
41028,59718,2021-07-29T06:09:24,1497253605,02/07/2021 10:16,Meter,57044,58642,1598,1076,9.207,4.173842884,TRUE
74934,30213,2021-07-29T06:09:24,423494121,02/07/2021 10:16,Meter,28794,29631,837,582,5.886,3.531381972,TRUE
76302,75978,2021-07-29T06:09:24,1228761617,02/07/2021 10:16,Meter,73717,75077,1360,901,12.87,2.5002775,TRUE
76076,37786,2021-07-29T06:09:25,1765825621,02/07/2021 10:16,Meter,35267,36797,1530,989,9.909,3.56458054,TRUE
78643,22088,2021-07-29T06:09:25,155065118,02/07/2021 10:16,Meter,21036,21679,643,409,3.861,3.783253783,TRUE
78690,37470,2021-07-29T06:09:25,960429932,02/07/2021 10:16,Meter,35249,36612,1363,858,9.396,3.261266192,TRUE
79185,50625,2021-07-29T06:09:25,2034030842,02/07/2021 10:16,Meter,47632,49429,1797,1196,11.52,3.707837302,TRUE
79106,52156,2021-07-29T06:09:26,1497279046,02/07/2021 10:16,Meter,49647,51176,1529,980,9.3465,3.744717274,TRUE
79217,21318,2021-07-29T06:09:26,423508447,02/07/2021 10:16,Meter,20278,20906,628,412,4.536,3.243890149,TRUE
78967,44771,2021-07-29T06:09:26,691916455,02/07/2021 10:16,Meter,43872,44411,539,360,8.424,1.526251526,TRUE
79127,36118,2021-07-29T06:09:28,2034033559,02/07/2021 10:16,Meter,34028,35294,1266,824,8.262,3.561918595,TRUE
78875,47998,2021-07-29T06:09:28,1228723579,02/07/2021 10:16,Meter,45608,47029,1421,969,9.963,3.473566482,TRUE
78865,48764,2021-07-29T06:09:29,691992778,02/07/2021 10:16,Meter,46523,47901,1378,863,9.045,3.407565348,TRUE
78877,34687,2021-07-29T06:09:29,1228726296,02/07/2021 10:16,Meter,32927,33959,1032,728,6.804,3.821281599,TRUE
79123,147897,2021-07-29T06:09:31,1497312638,02/07/2021 10:16,Meter,140682,144874,4192,3023,20.52,5.261417432,TRUE
91011,29777,2021-07-29T06:09:31,1497473435,02/07/2021 10:16,Meter,27921,29034,1113,743,7.776,3.412514697,TRUE
17400,43594,2021-07-29T06:09:31,1765686807,02/07/2021 10:16,Meter,42288,43070,782,524,5.297,3.532997114,TRUE
72990,36388,2021-07-29T06:09:32,1765742135,02/07/2021 10:16,Meter,34328,35594,1266,794,8.073,3.512590469,TRUE
64166,23608,2021-07-29T06:09:32,1228800396,02/07/2021 10:16,Meter,22765,23279,514,329,4.212,2.789648623,TRUE
79351,46578,2021-07-29T06:09:32,1497191855,02/07/2021 10:16,Meter,44363,45726,1363,852,6.48,4.695767196,TRUE
79388,50311,2021-07-29T06:09:32,2034080242,02/07/2021 10:16,Meter,47903,49378,1475,933,7.02,4.746642247,TRUE
79353,36849,2021-07-29T06:09:33,1497213838,02/07/2021 10:16,Meter,34786,35988,1202,861,8.262,3.721859114,TRUE
79562,19850,2021-07-29T06:09:33,155134031,02/07/2021 10:16,Meter,18761,19427,666,423,4.86,3.108465608,TRUE
17540,32080,2021-07-29T06:09:33,1497231622,02/07/2021 10:16,Meter,30510,31591,1081,489,8.1,2.156084656,TRUE
80112,34379,2021-07-29T06:09:33,1497127882,02/07/2021 10:16,Meter,32400,33606,1206,773,9.315,2.963729775,TRUE
80210,47377,2021-07-29T06:09:34,1228666522,02/07/2021 10:16,Meter,45014,46449,1435,928,9.504,3.487253487,TRUE
79851,30931,2021-07-29T06:09:34,423492392,02/07/2021 10:16,Meter,29117,30236,1119,695,6.48,3.830467372,TRUE
79766,60344,2021-07-29T06:09:34,692005128,02/07/2021 10:16,Meter,57160,59125,1965,1219,14.283,3.048079135,TRUE
80534,29747,2021-07-29T06:09:35,692035262,02/07/2021 10:16,Meter,28016,29078,1062,669,7.452,3.206234184,TRUE
79967,54857,2021-07-29T06:09:35,2034212140,02/07/2021 10:16,Meter,52303,53857,1554,1000,9.648,3.701729448,TRUE
80312,42140,2021-07-29T06:09:35,2034108894,02/07/2021 10:16,Meter,39639,41109,1470,1031,9.72,3.788212816,TRUE
80176,39018,2021-07-29T06:09:35,1765815000,02/07/2021 10:16,Meter,36663,38063,1400,955,9.396,3.629964118,TRUE
80266,62809,2021-07-29T06:09:36,691945601,02/07/2021 10:16,Meter,60005,61671,1666,1138,10.2465,3.966511213,TRUE
79950,33114,2021-07-29T06:09:36,155072775,02/07/2021 10:16,Meter,31161,32311,1150,803,7.776,3.688087889,TRUE
79526,43975,2021-07-29T06:09:36,423543274,02/07/2021 10:16,Meter,41772,43062,1290,913,9.99,3.263978264,TRUE
79668,36560,2021-07-29T06:09:36,691853964,02/07/2021 10:16,Meter,34597,35782,1185,778,8.262,3.363073625,TRUE
79666,33203,2021-07-29T06:09:37,1228726543,02/07/2021 10:16,Meter,31474,32501,1027,702,6.804,3.684807256,TRUE
79695,34887,2021-07-29T06:09:37,1228771003,02/07/2021 10:16,Meter,32801,34028,1227,859,8.316,3.689101903,TRUE
80426,39492,2021-07-29T06:09:37,1765641853,02/07/2021 10:16,Meter,36882,38433,1551,1059,9.72,3.891093474,TRUE
79686,27336,2021-07-29T06:09:37,960289142,02/07/2021 10:16,Meter,25834,26707,873,629,6.804,3.301629294,TRUE
79943,47882,2021-07-29T06:09:38,960342494,02/07/2021 10:16,Meter,45239,46848,1609,1034,12.096,3.052957294,TRUE
80274,16229,2021-07-29T06:09:38,960343235,02/07/2021 10:16,Meter,15211,15821,610,408,4.374,3.331373702,TRUE
79606,45065,2021-07-29T06:09:38,423420268,02/07/2021 10:16,Meter,42945,44196,1251,869,8.064,3.848674887,TRUE
79412,39152,2021-07-29T06:09:38,154982867,02/07/2021 10:16,Meter,37047,38311,1264,841,8.019,3.74556856,TRUE
80346,46993,2021-07-29T06:09:39,423488687,02/07/2021 10:16,Meter,44492,45964,1472,1029,9.504,3.866792929,TRUE
80341,40884,2021-07-29T06:09:39,1228761370,02/07/2021 10:16,Meter,38789,40097,1308,787,6.48,4.337522046,TRUE
79673,37599,2021-07-29T06:09:39,2034062458,02/07/2021 10:16,Meter,35674,36872,1198,727,6.48,4.006834215,TRUE
79862,44124,2021-07-29T06:09:39,691884592,02/07/2021 10:16,Meter,42107,43343,1236,781,6.48,4.304453263,TRUE
79389,48961,2021-07-29T06:09:40,1765633455,02/07/2021 10:16,Meter,46758,48115,1357,846,6.21,4.865424431,TRUE
80491,33065,2021-07-29T06:09:40,691924112,02/07/2021 10:16,Meter,31435,32408,973,657,5.4,4.345238095,TRUE
80490,36330,2021-07-29T06:09:40,691935968,02/07/2021 10:16,Meter,34576,35641,1065,689,5.4,4.556878307,TRUE
80648,32929,2021-07-29T06:09:40,1228745562,02/07/2021 10:16,Meter,31359,32306,947,623,8.991,2.474696919,TRUE
78058,54005,2021-07-29T06:09:41,1497398841,02/07/2021 10:16,Meter,51554,53042,1488,963,10.2465,3.356546835,TRUE
81247,11526,2021-07-29T06:09:41,155057955,02/07/2021 10:16,Meter,10946,11335,389,191,2.97,2.296777297,TRUE
81026,36898,2021-07-29T06:09:41,1765648769,02/07/2021 10:16,Meter,34579,35964,1385,934,8.262,4.037417436,TRUE
77384,98363,2021-07-29T06:09:41,960371887,02/07/2021 10:16,Meter,92182,95803,3621,2560,21.2625,4.299991602,TRUE
81119,21647,2021-07-29T06:09:42,691929299,02/07/2021 10:16,Meter,20713,21258,545,389,3.825,3.632119514,TRUE
81000,40161,2021-07-29T06:09:42,960367441,02/07/2021 10:16,Meter,38029,39301,1272,860,7.776,3.949882422,TRUE
80724,41398,2021-07-29T06:09:42,960348175,02/07/2021 10:16,Meter,39124,40478,1354,920,8.991,3.654448099,TRUE
81134,15322,2021-07-29T06:09:45,2034109141,02/07/2021 10:16,Meter,14655,15062,407,260,4.32,2.149470899,TRUE
81090,50338,2021-07-29T06:09:46,1765678162,02/07/2021 10:16,Meter,47868,49361,1493,977,10.2465,3.405343985,TRUE
81079,97363,2021-07-29T06:09:46,423493627,02/07/2021 10:16,Meter,93659,95837,2178,1526,21.024,2.592275495,TRUE
80964,35252,2021-07-29T06:09:46,960407455,02/07/2021 10:16,Meter,33585,34593,1008,659,6.48,3.632054674,TRUE
81291,23127,2021-07-29T06:09:46,155051780,02/07/2021 10:16,Meter,21616,22533,917,594,7.9461,2.669773312,TRUE
81162,33143,2021-07-29T06:09:47,1765655191,02/07/2021 10:16,Meter,31340,32411,1071,732,6.804,3.842277652,TRUE
81695,24977,2021-07-29T06:09:47,1765670258,02/07/2021 10:16,Meter,23612,24425,813,552,7.2,2.738095238,TRUE
81858,27360,2021-07-29T06:09:47,960364724,02/07/2021 10:16,Meter,26003,26830,827,530,5.508,3.436559809,TRUE
81879,45685,2021-07-29T06:09:47,423477819,02/07/2021 10:16,Meter,43255,44712,1457,973,9.216,3.770616319,TRUE
75765,22051,2021-07-29T06:09:48,2034113834,02/07/2021 10:16,Meter,20674,21519,845,532,5.481,3.466520708,TRUE
82150,61816,2021-07-29T06:09:48,960371393,02/07/2021 10:16,Meter,58433,60510,2077,1306,13.869,3.363101676,TRUE
38874,124645,2021-07-29T06:09:49,2034321314,02/07/2021 10:16,Meter,121427,123497,2070,1148,15.075,2.71973466,TRUE
82273,38299,2021-07-29T06:09:49,691978946,02/07/2021 10:16,Meter,36213,37467,1254,832,9.1233,3.256966856,TRUE
82294,55023,2021-07-29T06:09:49,1497251876,02/07/2021 10:16,Meter,52394,53944,1550,1079,11.34,3.398211136,TRUE
86340,104445,2021-07-29T06:09:49,960549233,02/07/2021 10:16,Meter,98232,101915,3683,2530,21.78,4.148629149,TRUE
81833,28464,2021-07-29T06:09:50,960407208,02/07/2021 10:16,Meter,26947,27876,929,588,6.48,3.240740741,TRUE
81905,27392,2021-07-29T06:09:50,691927817,02/07/2021 10:16,Meter,26038,26862,824,530,5.2974,3.573181453,TRUE
80162,46603,2021-07-29T06:09:50,423637381,02/07/2021 10:16,Meter,44353,45768,1415,835,10.26,2.906571986,TRUE
81974,27040,2021-07-29T06:09:50,1497431198,02/07/2021 10:16,Meter,25532,26443,911,597,5.76,3.701636905,TRUE
82272,28405,2021-07-29T06:09:50,2034101237,02/07/2021 10:16,Meter,27141,27903,762,502,5.4,3.32010582,TRUE
82379,23949,2021-07-29T06:09:51,155074504,02/07/2021 10:16,Meter,22656,23452,796,497,5.184,3.423996914,TRUE
81667,24699,2021-07-29T06:09:51,155064624,02/07/2021 10:16,Meter,23518,24239,721,460,4.608,3.565228175,TRUE
79966,83066,2021-07-29T06:09:51,1765659390,02/07/2021 10:16,Meter,79199,81468,2269,1598,12.42,4.595123073,TRUE
82940,52636,2021-07-29T06:09:51,155080926,02/07/2021 10:16,Meter,49950,51576,1626,1060,10.854,3.487851747,TRUE
39927,24068,2021-07-29T06:09:52,1765680385,02/07/2021 10:16,Meter,22826,23570,744,498,4.7088,3.77712247,TRUE
74113,37515,2021-07-29T06:09:52,2034093333,02/07/2021 10:17,Meter,35634,36783,1149,732,7.425,3.520923521,TRUE
82925,49150,2021-07-29T06:09:52,960355338,02/07/2021 10:17,Meter,46465,48094,1629,1056,9.18,4.108309991,TRUE
83186,23836,2021-07-29T06:09:52,1228808300,02/07/2021 10:17,Meter,22537,23316,779,520,5.427,3.422043223,TRUE
83187,51255,2021-07-29T06:09:53,1497232857,02/07/2021 10:17,Meter,48726,50260,1534,995,10.044,3.53800421,TRUE
83213,33121,2021-07-29T06:09:53,691923124,02/07/2021 10:17,Meter,31534,32497,963,624,6.1803,3.60592759,TRUE
82693,30796,2021-07-29T06:09:53,155057461,02/07/2021 10:17,Meter,29201,30164,963,632,6.03,3.743188818,TRUE
82473,20507,2021-07-29T06:09:53,2034109635,02/07/2021 10:17,Meter,19301,20036,735,471,5.508,3.053999378,TRUE
83178,47105,2021-07-29T06:09:54,1765674210,02/07/2021 10:17,Meter,44545,46020,1475,1085,9.347,4.145715203,TRUE
82708,32590,2021-07-29T06:09:54,1228762605,02/07/2021 10:17,Meter,30872,31905,1033,685,6.912,3.539393188,TRUE
82534,16181,2021-07-29T06:09:54,1229038010,02/07/2021 10:17,Meter,15568,15772,204,409,5.184,2.817735891,TRUE
82631,54628,2021-07-29T06:09:55,1497115532,02/07/2021 10:17,Meter,51172,53291,2119,1337,12.06,3.959369818,TRUE
82579,47122,2021-07-29T06:09:55,1497252123,02/07/2021 10:17,Meter,44819,46205,1386,917,9.045,3.620784964,TRUE
82730,49087,2021-07-29T06:09:55,691907563,02/07/2021 10:17,Meter,45983,47804,1821,1283,11.592,3.952849256,TRUE
82948,54204,2021-07-29T06:09:55,691971783,02/07/2021 10:17,Meter,51644,53193,1549,1011,9.1233,3.957684484,TRUE
82942,49905,2021-07-29T06:09:56,155014483,02/07/2021 10:17,Meter,47530,48963,1433,942,8.7435,3.847756292,TRUE
82944,39620,2021-07-29T06:09:56,1497192102,02/07/2021 10:17,Meter,37510,38810,1300,810,8.829,3.276539974,TRUE
83078,29016,2021-07-29T06:09:56,1497278058,02/07/2021 10:17,Meter,27287,28339,1052,677,6.48,3.731261023,TRUE
83075,35333,2021-07-29T06:09:56,960408443,02/07/2021 10:17,Meter,33196,34455,1259,878,7.839,4.000145791,TRUE
82954,61644,2021-07-29T06:09:57,423450155,02/07/2021 10:17,Meter,58147,60224,2077,1420,12.1095,4.187975202,TRUE
82943,63270,2021-07-29T06:09:57,1765627774,02/07/2021 10:17,Meter,59638,61860,2222,1410,14.715,3.422163973,TRUE
83201,23743,2021-07-29T06:09:57,1765627527,02/07/2021 10:17,Meter,22509,23249,740,494,4.7088,3.746784137,TRUE
83073,68725,2021-07-29T06:09:57,2034063940,02/07/2021 10:17,Meter,64996,67244,2248,1481,14.4207,3.667842556,TRUE
81801,30323,2021-07-29T06:09:58,1765677421,02/07/2021 10:17,Meter,28411,29576,1165,747,7.308,3.65059817,TRUE
83269,43328,2021-07-29T06:09:59,960529226,02/07/2021 10:17,Meter,41242,42490,1248,838,9.068,3.300460016,TRUE
83063,30268,2021-07-29T06:10:00,155015224,02/07/2021 10:17,Meter,28665,29600,935,668,5.508,4.331362174,TRUE
46378,30906,2021-07-29T06:10:00,1228661088,02/07/2021 10:17,Meter,29601,30383,782,523,4.617,4.045607847,TRUE
83405,48286,2021-07-29T06:10:00,2034062705,02/07/2021 10:17,Meter,45786,47311,1525,975,12.9492,2.689079524,TRUE
80218,63616,2021-07-29T06:10:01,1497199265,02/07/2021 10:17,Meter,60627,62452,1825,1164,12.42,3.347135956,TRUE
83321,20820,2021-07-29T06:10:01,1765872798,02/07/2021 10:17,Meter,19786,20424,638,396,5.832,2.425044092,TRUE
82380,23235,2021-07-29T06:10:01,1497222977,02/07/2021 10:17,Meter,21987,22729,742,506,5.184,3.486000882,TRUE
83344,27487,2021-07-29T06:10:02,960349163,02/07/2021 10:17,Meter,25787,26809,1022,678,8.316,2.911770769,TRUE
83348,40848,2021-07-29T06:10:02,2034088887,02/07/2021 10:17,Meter,38484,39854,1370,994,10.989,3.230503231,TRUE
76727,12829,2021-07-29T06:10:02,960406714,02/07/2021 10:17,Meter,12169,12571,402,258,2.448,3.764005602,TRUE
82726,43355,2021-07-29T06:10:02,1765649016,02/07/2021 10:17,Meter,40703,42300,1597,1055,9.72,3.876396238,TRUE
83640,31372,2021-07-29T06:10:04,423464728,02/07/2021 10:17,Meter,29581,30648,1067,724,8.568,3.017873816,TRUE
78007,39570,2021-07-29T06:10:09,692010315,02/07/2021 10:17,Meter,36948,38541,1593,1029,8.64,4.253472222,TRUE
83836,37056,2021-07-29T06:10:09,155222704,02/07/2021 10:17,Meter,35407,36485,1078,571,9.072,2.247889897,TRUE
83843,17076,2021-07-29T06:10:09,423483006,02/07/2021 10:17,Meter,15954,16644,690,432,4.523,3.41113673,TRUE
83842,28979,2021-07-29T06:10:10,691972030,02/07/2021 10:17,Meter,27443,28381,938,598,5.592,3.819231555,TRUE
83789,26038,2021-07-29T06:10:10,960373122,02/07/2021 10:17,Meter,24623,25448,825,590,5.184,4.064704586,TRUE
83846,29290,2021-07-29T06:10:10,691877182,02/07/2021 10:17,Meter,27703,28673,970,617,6.3,3.497732426,TRUE
83813,49409,2021-07-29T06:10:10,423678383,02/07/2021 10:17,Meter,46435,48243,1808,1166,11.34,3.672209625,TRUE
83671,50889,2021-07-29T06:10:11,1497341537,02/07/2021 10:17,Meter,48068,49794,1726,1095,9.72,4.023368607,TRUE
83713,40084,2021-07-29T06:10:13,960507984,02/07/2021 10:17,Meter,37906,39220,1314,864,7.776,3.968253968,TRUE
83703,44116,2021-07-29T06:10:13,960439812,02/07/2021 10:17,Meter,41979,43236,1257,880,7.946,3.955269498,TRUE
83712,55163,2021-07-29T06:10:13,1228943409,02/07/2021 10:17,Meter,52316,54031,1715,1132,10.251,3.943866104,TRUE
83864,32342,2021-07-29T06:10:14,2034249684,02/07/2021 10:17,Meter,30578,31647,1069,695,7.776,3.192056143,TRUE
83859,25896,2021-07-29T06:10:14,1497379575,02/07/2021 10:17,Meter,24501,25353,852,543,6.804,2.85021416,TRUE
83804,35075,2021-07-29T06:10:14,423599096,02/07/2021 10:17,Meter,29622,34257,4635,818,8.748,3.339538833,TRUE
83816,54171,2021-07-29T06:10:21,1497230387,02/07/2021 10:18,Meter,51288,53062,1774,1109,7.83,5.058383507,TRUE
84439,58510,2021-07-29T06:10:22,155134525,02/07/2021 10:18,Meter,55383,57282,1899,1228,11.178,3.923523247,TRUE
84356,32089,2021-07-29T06:10:22,1765599122,02/07/2021 10:18,Meter,30034,31273,1239,816,8.82,3.304178814,TRUE
84515,41389,2021-07-29T06:10:22,960359537,02/07/2021 10:18,Meter,39227,40566,1339,823,7.128,4.12357704,TRUE
84210,35563,2021-07-29T06:10:22,691885333,02/07/2021 10:18,Meter,33712,34925,1213,638,6.156,3.701383087,TRUE
84476,22123,2021-07-29T06:10:23,1765786595,02/07/2021 10:18,Meter,20983,21665,682,458,4.7088,3.473739139,TRUE
83725,40927,2021-07-29T06:10:23,1228806818,02/07/2021 10:18,Meter,38356,39923,1567,1004,9.3465,3.836424636,TRUE
52133,66613,2021-07-29T06:10:23,960236284,02/07/2021 10:18,Meter,64479,65887,1408,726,8.91,2.91005291,TRUE
83752,87068,2021-07-29T06:10:24,2034049367,02/07/2021 10:18,Meter,82533,85296,2763,1772,19.44,3.255437978,TRUE
83651,24892,2021-07-29T06:10:24,423648496,02/07/2021 10:18,Meter,23638,24399,761,493,5.22,3.373015873,TRUE
72465,78103,2021-07-29T06:10:24,155043876,02/07/2021 10:18,Meter,74146,76549,2403,1554,14.976,3.705929487,TRUE
67616,54510,2021-07-29T06:10:25,960362007,02/07/2021 10:18,Meter,52607,53773,1166,737,9.504,2.769510582,TRUE
72467,41073,2021-07-29T06:10:25,155028809,02/07/2021 10:18,Meter,39075,40257,1182,816,8.352,3.489326765,TRUE
77161,51999,2021-07-29T06:10:25,155064130,02/07/2021 10:18,Meter,49809,51132,1323,867,9.072,3.413170824,TRUE
58266,32637,2021-07-29T06:10:25,1497100465,02/07/2021 10:18,Meter,31329,32124,795,513,6.435,2.847152847,TRUE
68297,33613,2021-07-29T06:10:26,1497249900,02/07/2021 10:18,Meter,31472,32792,1320,821,6.696,4.378946919,TRUE
91568,24238,2021-07-29T06:10:26,2034087899,02/07/2021 10:18,Meter,22929,23727,798,511,6.3,2.896825397,TRUE
84846,33676,2021-07-29T06:10:26,423424467,02/07/2021 10:18,Meter,31436,32751,1315,925,7.5375,4.382847666,TRUE
85068,49536,2021-07-29T06:10:27,423659364,02/07/2021 10:18,Meter,46963,48518,1555,1018,9.072,4.007621567,TRUE
85069,52151,2021-07-29T06:10:27,1228809288,02/07/2021 10:18,Meter,49442,51065,1623,1086,9.6255,4.029475278,TRUE
85143,24181,2021-07-29T06:10:27,1228808547,02/07/2021 10:18,Meter,22680,23565,885,616,5.5917,3.934402776,TRUE
84941,26485,2021-07-29T06:10:28,423680112,02/07/2021 10:18,Meter,24910,25865,955,620,6.3,3.514739229,TRUE
84947,27348,2021-07-29T06:10:28,1765750780,02/07/2021 10:18,Meter,25636,26675,1039,673,6.615,3.633516899,TRUE
84950,26160,2021-07-29T06:10:28,1228987128,02/07/2021 10:18,Meter,24749,25615,866,545,5.04,3.861961451,TRUE
84953,18458,2021-07-29T06:10:28,155053015,02/07/2021 10:18,Meter,17198,17926,728,532,4.824,3.938640133,TRUE
85092,52566,2021-07-29T06:10:29,960295564,02/07/2021 10:18,Meter,49296,51234,1938,1332,13.608,3.495842782,TRUE
84869,20188,2021-07-29T06:10:29,155243205,02/07/2021 10:18,Meter,19064,19749,685,439,4.824,3.250118455,TRUE
85000,32467,2021-07-29T06:10:29,1228964898,02/07/2021 10:18,Meter,30417,31672,1255,795,9.504,2.987463925,TRUE
85079,46558,2021-07-29T06:10:29,691978452,02/07/2021 10:18,Meter,44336,45647,1311,911,6.804,4.781851012,TRUE
83597,49090,2021-07-29T06:10:30,155242464,02/07/2021 10:18,Meter,46304,47982,1678,1108,9.9495,3.977227858,TRUE
84864,31530,2021-07-29T06:10:30,1228915992,02/07/2021 10:18,Meter,29830,30878,1048,652,6.3315,3.677756343,TRUE
84434,32543,2021-07-29T06:10:30,154315720,02/07/2021 10:18,Meter,31110,32044,934,499,6.804,2.61925758,TRUE
85284,33957,2021-07-29T06:10:30,423442992,02/07/2021 10:18,Meter,31991,33203,1212,754,8.442,3.189833147,TRUE
85406,50502,2021-07-29T06:10:31,2034035041,02/07/2021 10:18,Meter,47215,49207,1992,1295,12.362,3.741303996,TRUE
85228,16008,2021-07-29T06:10:32,155103897,02/07/2021 10:18,Meter,15113,15653,540,355,3.618,3.504303877,TRUE
85299,29581,2021-07-29T06:10:33,1497244466,02/07/2021 10:18,Meter,27734,28866,1132,715,7.0632,3.615318027,TRUE
85341,34675,2021-07-29T06:10:33,423441757,02/07/2021 10:18,Meter,32844,33948,1104,727,7.0632,3.675994693,TRUE
85415,38531,2021-07-29T06:10:33,1228995279,02/07/2021 10:18,Meter,36493,37683,1190,848,7.29,4.154418969,TRUE
85362,39618,2021-07-29T06:10:33,1765613695,02/07/2021 10:18,Meter,37353,38711,1358,907,9.9495,3.255727136,TRUE
85314,19330,2021-07-29T06:10:34,1765672975,02/07/2021 10:18,Meter,18236,18888,652,442,4.455,3.54337021,TRUE
85316,43607,2021-07-29T06:10:34,1497226188,02/07/2021 10:18,Meter,41365,42757,1392,850,7.128,4.258858426,TRUE
78232,34144,2021-07-29T06:10:34,960291365,02/07/2021 10:18,Meter,32430,33427,997,717,7.488,3.419757326,TRUE
84943,38987,2021-07-29T06:10:34,1497400570,02/07/2021 10:18,Meter,36608,38052,1444,935,11.457,2.914624871,TRUE
92190,29085,2021-07-29T06:10:35,691986356,02/07/2021 10:18,Meter,27298,28365,1067,720,7.0632,3.640599971,TRUE
23012,48915,2021-07-29T06:10:35,2034301801,02/07/2021 10:18,Meter,46430,47868,1438,1047,8.748,4.274446404,TRUE
85485,30121,2021-07-29T06:10:35,692116525,02/07/2021 10:18,Meter,28221,29388,1167,733,7.839,3.339529459,TRUE
85471,26795,2021-07-29T06:10:35,692117266,02/07/2021 10:18,Meter,25317,26202,885,593,6.3,3.361678005,TRUE
85470,33948,2021-07-29T06:10:36,155043135,02/07/2021 10:18,Meter,32043,33179,1136,769,7.56,3.632842026,TRUE
85508,49853,2021-07-29T06:10:36,691872242,02/07/2021 10:18,Meter,47007,48741,1734,1112,11.178,3.552897273,TRUE
85414,47536,2021-07-29T06:10:36,2034260552,02/07/2021 10:18,Meter,41155,46345,5190,1191,10.944,3.886669799,TRUE
85369,33183,2021-07-29T06:10:37,1228845103,02/07/2021 10:18,Meter,31238,32389,1151,794,7.137,3.973258072,TRUE
85564,31651,2021-07-29T06:10:37,2034091357,02/07/2021 10:18,Meter,28895,30573,1678,1078,9.576,4.020467836,TRUE
85566,20359,2021-07-29T06:10:37,960345705,02/07/2021 10:18,Meter,19059,19835,776,524,5.184,3.610008818,TRUE
85580,67144,2021-07-29T06:10:37,1497400076,02/07/2021 10:18,Meter,64694,66252,1558,892,14.85,2.145262145,TRUE
85534,48841,2021-07-29T06:10:38,1228937234,02/07/2021 10:18,Meter,46139,47753,1614,1088,11.16,3.481822837,TRUE
85530,43969,2021-07-29T06:10:38,960314089,02/07/2021 10:18,Meter,41751,43102,1351,867,8.748,3.539584558,TRUE
85529,28071,2021-07-29T06:10:38,692045142,02/07/2021 10:18,Meter,26061,27272,1211,799,8.1,3.52292769,TRUE
85613,47453,2021-07-29T06:10:39,155244440,02/07/2021 10:18,Meter,44365,46252,1887,1201,12.663,3.387258718,TRUE
85617,29979,2021-07-29T06:10:39,960530461,02/07/2021 10:18,Meter,28128,29245,1117,734,7.6518,3.425897921,TRUE
85644,38506,2021-07-29T06:10:39,2034037017,02/07/2021 10:18,Meter,35751,37398,1647,1108,12.096,3.271447468,TRUE
84808,31966,2021-07-29T06:10:39,1765825374,02/07/2021 10:18,Meter,30114,31290,1176,676,8.789,2.746940169,TRUE
55916,44557,2021-07-29T06:10:40,423728771,02/07/2021 10:18,Meter,42817,43873,1056,684,7.308,3.342716397,TRUE
84805,42136,2021-07-29T06:10:40,960529967,02/07/2021 10:18,Meter,40166,41344,1178,792,7.722,3.663003663,TRUE
86383,56595,2021-07-29T06:10:41,1229034552,02/07/2021 10:18,Meter,53586,55365,1779,1230,11.97,3.669889008,TRUE
85786,16909,2021-07-29T06:10:41,1497245207,02/07/2021 10:18,Meter,16048,16554,506,355,2.655,4.77535647,TRUE
85673,27474,2021-07-29T06:10:41,1765679150,02/07/2021 10:18,Meter,25884,26844,960,630,5.832,3.858024691,TRUE
85753,26140,2021-07-29T06:10:41,155102909,02/07/2021 10:18,Meter,24533,25492,959,648,6.975,3.31797235,TRUE
85670,29214,2021-07-29T06:10:42,1497220507,02/07/2021 10:18,Meter,27923,28696,773,518,12.312,1.50259909,TRUE
85778,16212,2021-07-29T06:10:42,960349657,02/07/2021 10:18,Meter,14362,15468,1106,744,8.7435,3.038992231,TRUE
70230,45038,2021-07-29T06:10:42,691906328,02/07/2021 10:18,Meter,42944,44221,1277,817,8.222,3.548841088,TRUE
85864,17136,2021-07-29T06:10:42,1765679891,02/07/2021 10:18,Meter,16149,16753,604,383,4.212,3.247524081,TRUE
85865,23801,2021-07-29T06:10:43,1228748032,02/07/2021 10:18,Meter,22436,23249,813,552,5.508,3.579209462,TRUE
85867,38680,2021-07-29T06:10:43,1765826856,02/07/2021 10:18,Meter,36356,37768,1412,912,9.396,3.466520708,TRUE
85868,33412,2021-07-29T06:10:43,2034054307,02/07/2021 10:18,Meter,31702,32750,1048,662,6.804,3.474846729,TRUE
85872,39663,2021-07-29T06:10:44,691977711,02/07/2021 10:18,Meter,37535,38779,1244,884,6.9345,4.552805332,TRUE
85878,30470,2021-07-29T06:10:44,423542533,02/07/2021 10:18,Meter,28415,29661,1246,809,7.425,3.891293891,TRUE
85977,14223,2021-07-29T06:10:44,960414371,02/07/2021 10:18,Meter,13439,13921,482,302,2.916,3.698804625,TRUE
85978,24457,2021-07-29T06:10:45,1497280281,02/07/2021 10:18,Meter,23297,24003,706,454,5.85,2.771672772,TRUE
85979,27312,2021-07-29T06:10:45,423537840,02/07/2021 10:18,Meter,26012,26809,797,503,5.427,3.310168733,TRUE
85967,23776,2021-07-29T06:10:45,423536111,02/07/2021 10:18,Meter,22213,23163,950,613,6.3,3.475056689,TRUE
96932,38454,2021-07-29T06:10:45,1497467754,02/07/2021 10:18,Meter,35974,37488,1514,966,9.396,3.671775223,TRUE
86053,36971,2021-07-29T06:10:46,1765649510,02/07/2021 10:18,Meter,34585,36055,1470,916,11.088,2.950422593,TRUE
85398,33842,2021-07-29T06:10:46,1765620117,02/07/2021 10:18,Meter,31802,33025,1223,817,8.6625,3.368377654,TRUE
86001,21719,2021-07-29T06:10:46,423685793,02/07/2021 10:18,Meter,20499,21242,743,477,4.7088,3.617846221,TRUE
86108,58089,2021-07-29T06:10:47,423361729,02/07/2021 10:18,Meter,55044,56883,1839,1206,11.52,3.738839286,TRUE
86082,20599,2021-07-29T06:10:47,155000898,02/07/2021 10:18,Meter,19157,20037,880,562,6.4746,3.100026036,TRUE
86103,39238,2021-07-29T06:10:47,155006332,02/07/2021 10:18,Meter,36685,38244,1559,994,9.1233,3.891135883,TRUE
85487,19051,2021-07-29T06:10:49,423572420,02/07/2021 10:18,Meter,17839,18580,741,471,5.832,2.884332745,TRUE
86190,43652,2021-07-29T06:10:49,960362501,02/07/2021 10:18,Meter,41280,42698,1418,954,9.18,3.711484594,TRUE
86439,44924,2021-07-29T06:10:49,1228844856,02/07/2021 10:18,Meter,42574,43999,1425,925,9.396,3.515933832,TRUE
86070,40276,2021-07-29T06:10:50,960293094,02/07/2021 10:18,Meter,37558,39169,1611,1107,9.828,4.022762951,TRUE
86440,36335,2021-07-29T06:10:50,1228767792,02/07/2021 10:18,Meter,34252,35532,1280,803,7.776,3.688087889,TRUE
86278,26894,2021-07-29T06:10:50,1228956253,02/07/2021 10:18,Meter,24006,26340,2334,554,5.04,3.925736961,TRUE
86405,30006,2021-07-29T06:10:50,2034262528,02/07/2021 10:18,Meter,28134,29229,1095,777,7.434,3.732849072,TRUE
86254,34311,2021-07-29T06:10:51,2034293650,02/07/2021 10:19,Meter,32127,33469,1342,842,10.044,2.993969392,TRUE
85915,43712,2021-07-29T06:10:51,1497401064,02/07/2021 10:19,Meter,41161,42710,1549,1002,10.044,3.562894692,TRUE
86330,160587,2021-07-29T06:10:51,960372134,02/07/2021 10:19,Meter,150827,156558,5731,4029,36.72,3.918650794,TRUE
86101,55255,2021-07-29T06:10:51,960413383,02/07/2021 10:19,Meter,52732,54187,1455,1068,11.439,3.334457308,TRUE
86204,19241,2021-07-29T06:10:52,155106614,02/07/2021 10:19,Meter,18087,18779,692,462,5.022,3.285543608,TRUE
85882,40144,2021-07-29T06:10:52,1497430704,02/07/2021 10:19,Meter,37727,39175,1448,969,8.829,3.919712635,TRUE
85885,29090,2021-07-29T06:10:52,423637134,02/07/2021 10:19,Meter,27341,28391,1050,699,6.4746,3.855726333,TRUE
86335,58458,2021-07-29T06:10:53,2034149896,02/07/2021 10:19,Meter,55386,57236,1850,1222,11.772,3.707344304,TRUE
86086,30118,2021-07-29T06:10:53,155015965,02/07/2021 10:19,Meter,28330,29414,1084,704,7.128,3.527336861,TRUE
78631,33910,2021-07-29T06:10:53,155267164,02/07/2021 10:19,Meter,32044,33170,1126,740,7.128,3.707712041,TRUE
86085,29265,2021-07-29T06:10:53,1497279787,02/07/2021 10:19,Meter,27575,28606,1031,659,8.2404,2.856137358,TRUE
86083,47849,2021-07-29T06:10:54,691932510,02/07/2021 10:19,Meter,45399,46886,1487,963,9.4176,3.651976846,TRUE
86043,60412,2021-07-29T06:10:54,423436817,02/07/2021 10:19,Meter,57296,59184,1888,1228,11.772,3.725547304,TRUE
86323,44179,2021-07-29T06:10:54,960321499,02/07/2021 10:19,Meter,41245,42794,1549,1385,12.6549,3.90870617,TRUE
86045,30246,2021-07-29T06:10:54,423436570,02/07/2021 10:19,Meter,28466,29550,1084,696,6.4746,3.839178151,TRUE
86044,36078,2021-07-29T06:10:55,1765613942,02/07/2021 10:19,Meter,33685,35149,1464,929,9.418,3.5228893,TRUE
86047,24156,2021-07-29T06:10:55,691871995,02/07/2021 10:19,Meter,22905,23654,749,502,4.709,3.807299093,TRUE
84364,40168,2021-07-29T06:10:55,960529473,02/07/2021 10:19,Meter,37857,39269,1412,899,9.216,3.483847966,TRUE
85404,38750,2021-07-29T06:10:55,1497348700,02/07/2021 10:19,Meter,36352,37775,1423,975,9.293,3.747059999,TRUE
86040,38038,2021-07-29T06:10:56,155001145,02/07/2021 10:19,Meter,36104,37276,1172,762,7.0632,3.852968303,TRUE
72782,40238,2021-07-29T06:10:56,2034293403,02/07/2021 10:19,Meter,38065,39362,1297,876,9.356,3.343919868,TRUE
86650,39093,2021-07-29T06:10:56,2034301554,02/07/2021 10:19,Meter,36952,38253,1301,840,8.748,3.429355281,TRUE
86626,24729,2021-07-29T06:10:56,423561058,02/07/2021 10:19,Meter,23299,24181,882,548,8.91,2.196568863,TRUE
86671,52585,2021-07-29T06:10:57,423630959,02/07/2021 10:19,Meter,49564,51366,1802,1219,9.95,4.375448672,TRUE
86625,158181,2021-07-29T06:10:58,960519593,02/07/2021 10:19,Meter,145006,154920,9914,3261,32.292,3.606598715,TRUE
47245,73083,2021-07-29T06:10:59,1228965145,02/07/2021 10:19,Meter,70627,72029,1402,1054,9.45,3.983371126,TRUE
85667,30620,2021-07-29T06:10:59,155213812,02/07/2021 10:19,Meter,28865,29911,1046,709,6.048,4.186744142,TRUE
86638,25959,2021-07-29T06:10:59,960331626,02/07/2021 10:19,Meter,24495,25402,907,557,7.9461,2.503474301,TRUE
86042,35220,2021-07-29T06:10:59,2034049120,02/07/2021 10:19,Meter,33497,34542,1045,678,6.7689,3.577285189,TRUE
86084,38907,2021-07-29T06:11:00,1497126647,02/07/2021 10:19,Meter,36841,38091,1250,816,7.9461,3.667567378,TRUE
20844,19825,2021-07-29T06:11:00,960551456,02/07/2021 10:19,Meter,18839,19432,593,393,3.902,3.597056455,TRUE
86339,57775,2021-07-29T06:11:00,1497100959,02/07/2021 10:19,Meter,54138,56305,2167,1470,11.772,4.459734964,TRUE
85921,32174,2021-07-29T06:11:00,692127146,02/07/2021 10:19,Meter,29949,31287,1338,887,9.396,3.371495469,TRUE
85356,33776,2021-07-29T06:11:01,1228965392,02/07/2021 10:19,Meter,31824,32964,1140,812,6.3315,4.580273237,TRUE
86865,51411,2021-07-29T06:11:01,1765719411,02/07/2021 10:19,Meter,48574,50308,1734,1103,12.06,3.266406065,TRUE
86885,43700,2021-07-29T06:11:01,2034065175,02/07/2021 10:19,Meter,41041,42607,1566,1093,9.5,4.109022556,TRUE
86945,20675,2021-07-29T06:11:02,1765715706,02/07/2021 10:19,Meter,19477,20206,729,469,4.536,3.692680776,TRUE
86946,14840,2021-07-29T06:11:02,155111554,02/07/2021 10:19,Meter,13955,14479,524,361,3.618,3.563531549,TRUE
86931,22628,2021-07-29T06:11:02,1497163944,02/07/2021 10:19,Meter,21188,22038,850,590,5.796,3.635512176,TRUE
86155,26725,2021-07-29T06:11:02,960306926,02/07/2021 10:19,Meter,25380,26183,803,542,5.2974,3.654083674,TRUE
86868,39231,2021-07-29T06:11:03,423681594,02/07/2021 10:19,Meter,37023,38328,1305,903,8.064,3.999255952,TRUE
87182,33334,2021-07-29T06:11:03,691888050,02/07/2021 10:19,Meter,31119,32496,1377,838,9.1233,3.280454597,TRUE
87183,19034,2021-07-29T06:11:03,960520581,02/07/2021 10:19,Meter,17886,18557,671,477,4.1202,4.134681395,TRUE
86792,33464,2021-07-29T06:11:03,1497389702,02/07/2021 10:19,Meter,31718,32774,1056,690,6.48,3.802910053,TRUE
86939,24822,2021-07-29T06:11:04,2034290686,02/07/2021 10:19,Meter,23144,24158,1014,664,6.156,3.85222315,TRUE
87074,35892,2021-07-29T06:11:04,960521075,02/07/2021 10:19,Meter,33751,35049,1298,843,7.722,3.898878899,TRUE
87086,43951,2021-07-29T06:11:04,423648990,02/07/2021 10:19,Meter,41470,42933,1463,1018,9.504,3.82545695,TRUE
87249,50909,2021-07-29T06:11:08,1228785082,02/07/2021 10:19,Meter,47843,49662,1819,1247,12.6,3.534580499,TRUE
87288,45211,2021-07-29T06:11:10,960552691,02/07/2021 10:19,Meter,42373,44027,1654,1184,9.765,4.330334284,TRUE
87190,32491,2021-07-29T06:11:10,1765629750,02/07/2021 10:19,Meter,30542,31719,1177,772,7.452,3.699869642,TRUE
87098,48587,2021-07-29T06:11:10,960550715,02/07/2021 10:19,Meter,46049,47557,1508,1030,9.72,3.784538507,TRUE
86834,19664,2021-07-29T06:11:11,1228997996,02/07/2021 10:19,Meter,18598,19245,647,419,4.86,3.079071135,TRUE
72571,39968,2021-07-29T06:11:11,691946095,02/07/2021 10:19,Meter,37817,39123,1306,845,8.928,3.380216334,TRUE
87420,44422,2021-07-29T06:11:11,691859398,02/07/2021 10:19,Meter,41242,43081,1839,1341,12.096,3.959396259,TRUE
87421,35410,2021-07-29T06:11:11,691859151,02/07/2021 10:19,Meter,33327,34590,1263,820,9.504,3.081409331,TRUE
87478,78859,2021-07-29T06:11:12,155245922,02/07/2021 10:19,Meter,74596,77165,2569,1694,16.524,3.66134108,TRUE
87527,39414,2021-07-29T06:11:12,1228729754,02/07/2021 10:19,Meter,36722,38386,1664,1028,12.06,3.044302298,TRUE
83037,31493,2021-07-29T06:11:12,960440800,02/07/2021 10:19,Meter,29521,30724,1203,769,6.5205,4.211990754,TRUE
86188,42185,2021-07-29T06:11:13,691927076,02/07/2021 10:19,Meter,40341,41458,1117,727,9.18,2.828353564,TRUE
87556,22554,2021-07-29T06:11:13,423658623,02/07/2021 10:19,Meter,21286,22058,772,496,4.824,3.672115612,TRUE
87557,33919,2021-07-29T06:11:13,692116278,02/07/2021 10:19,Meter,32040,33187,1147,732,7.236,3.612887941,TRUE
20862,55980,2021-07-29T06:11:13,1497431692,02/07/2021 10:19,Meter,53879,55157,1278,823,9.36,3.140262515,TRUE
86175,27194,2021-07-29T06:11:14,1497315355,02/07/2021 10:19,Meter,25469,26515,1046,679,6.372,3.805712492,TRUE
87599,31555,2021-07-29T06:11:14,423460776,02/07/2021 10:19,Meter,29545,30740,1195,815,7.6518,3.803960226,TRUE
87126,74365,2021-07-29T06:11:14,960364230,02/07/2021 10:19,Meter,70008,72513,2505,1852,12.825,5.157337789,TRUE
85919,38820,2021-07-29T06:11:14,960560595,02/07/2021 10:19,Meter,36861,38065,1204,755,7.236,3.726407644,TRUE
87821,39871,2021-07-29T06:11:15,691896201,02/07/2021 10:19,Meter,37581,38962,1381,909,9.347,3.473230525,TRUE
87830,34615,2021-07-29T06:11:15,1228749514,02/07/2021 10:19,Meter,32600,33821,1221,794,7.776,3.646751911,TRUE
87893,21813,2021-07-29T06:11:15,1497222483,02/07/2021 10:19,Meter,19640,21292,1652,521,5.427,3.428624075,TRUE
87859,44091,2021-07-29T06:11:15,2034097038,02/07/2021 10:19,Meter,41738,43134,1396,957,9.072,3.767479214,TRUE
87873,47479,2021-07-29T06:11:16,1228996020,02/07/2021 10:19,Meter,45034,46482,1448,997,9.045,3.936665877,TRUE
87789,19173,2021-07-29T06:11:16,1228771991,02/07/2021 10:19,Meter,17923,18657,734,516,5.796,3.179532683,TRUE
87809,55452,2021-07-29T06:11:16,960551209,02/07/2021 10:19,Meter,52287,54206,1919,1246,12.96,3.433641975,TRUE
87905,47575,2021-07-29T06:11:16,155245428,02/07/2021 10:19,Meter,44901,46494,1593,1081,10.8,3.57473545,TRUE
87903,94425,2021-07-29T06:11:17,423692215,02/07/2021 10:19,Meter,88549,91994,3445,2431,18.63,4.660302124,TRUE
87808,56385,2021-07-29T06:11:17,692115537,02/07/2021 10:19,Meter,53210,55050,1840,1335,10.602,4.497129922,TRUE
88056,46111,2021-07-29T06:11:17,1228799408,02/07/2021 10:19,Meter,43164,44892,1728,1219,10.044,4.33449963,TRUE
88108,43906,2021-07-29T06:11:17,1228997502,02/07/2021 10:19,Meter,41084,42739,1655,1167,10.044,4.149598908,TRUE
88112,17458,2021-07-29T06:11:18,2034125443,02/07/2021 10:19,Meter,16419,17025,606,433,3.8259,4.041999455,TRUE
88225,26113,2021-07-29T06:11:18,692122700,02/07/2021 10:19,Meter,24033,25299,1266,814,8.424,3.451024284,TRUE
88229,50212,2021-07-29T06:11:18,1228785576,02/07/2021 10:19,Meter,47333,49013,1680,1199,10.854,3.945220985,TRUE
88280,32962,2021-07-29T06:11:19,1497281022,02/07/2021 10:19,Meter,30785,32068,1283,894,8.748,3.649813835,TRUE
85086,40543,2021-07-29T06:11:19,1497324494,02/07/2021 10:19,Meter,38140,39603,1463,940,7.236,4.639500908,TRUE
84508,32223,2021-07-29T06:11:19,1497185433,02/07/2021 10:19,Meter,30176,31402,1226,821,9.063,3.235289482,TRUE
87079,27570,2021-07-29T06:11:19,423648002,02/07/2021 10:19,Meter,25989,26954,965,616,6.03,3.648424544,TRUE
88199,44514,2021-07-29T06:11:20,1228807806,02/07/2021 10:19,Meter,41993,43492,1499,1022,6.372,5.728185813,TRUE
41095,45428,2021-07-29T06:11:20,2034244991,02/07/2021 10:19,Meter,42990,44480,1490,948,10.08,3.358843537,TRUE
88614,42269,2021-07-29T06:11:20,960562818,02/07/2021 10:19,Meter,39852,41320,1468,949,10.044,3.374438186,TRUE
88769,42077,2021-07-29T06:11:20,423561799,02/07/2021 10:19,Meter,39604,41109,1505,968,7.56,4.572940287,TRUE
87753,28863,2021-07-29T06:11:21,1765759919,02/07/2021 10:19,Meter,27097,28251,1154,612,6.588,3.317720531,TRUE
88679,27593,2021-07-29T06:11:21,960346199,02/07/2021 10:19,Meter,26157,26937,780,656,6.4746,3.618535729,TRUE
88905,39039,2021-07-29T06:11:21,2034154836,02/07/2021 10:19,Meter,36509,37996,1487,1043,10.044,3.7086818,TRUE
88970,54848,2021-07-29T06:11:22,2034148414,02/07/2021 10:19,Meter,51484,53535,2051,1313,12.96,3.618276014,TRUE
88949,18731,2021-07-29T06:11:22,155213565,02/07/2021 10:20,Meter,17641,18307,666,424,3.888,3.894767784,TRUE
88990,41406,2021-07-29T06:11:22,1228848808,02/07/2021 10:20,Meter,38753,40356,1603,1050,10.044,3.733572282,TRUE
89253,31030,2021-07-29T06:11:23,155016953,02/07/2021 10:20,Meter,29015,30246,1231,784,10.044,2.787733971,TRUE
89016,44330,2021-07-29T06:11:23,1228979718,02/07/2021 10:20,Meter,41934,43371,1437,959,9.45,3.624338624,TRUE
89205,32563,2021-07-29T06:11:26,155030291,02/07/2021 10:20,Meter,30651,31992,1341,571,7.839,2.601461557,TRUE
88951,26510,2021-07-29T06:11:26,2034271173,02/07/2021 10:20,Meter,24948,25871,923,639,7.128,3.201659452,TRUE
88953,37107,2021-07-29T06:11:26,960366700,02/07/2021 10:20,Meter,34793,36216,1423,891,5.94,5.357142857,TRUE
88401,19649,2021-07-29T06:11:26,960563312,02/07/2021 10:20,Meter,18257,19112,855,537,5.184,3.699570106,TRUE
88608,44373,2021-07-29T06:11:27,2034304024,02/07/2021 10:20,Meter,41728,43328,1600,1045,9.72,3.839653145,TRUE
88635,39592,2021-07-29T06:11:27,1765835748,02/07/2021 10:20,Meter,37111,38624,1513,968,9.347,3.698665729,TRUE
89129,37318,2021-07-29T06:11:27,2034292662,02/07/2021 10:20,Meter,34990,36371,1381,947,8.748,3.866189823,TRUE
88604,22279,2021-07-29T06:11:28,960561336,02/07/2021 10:20,Meter,20944,21753,809,526,5.508,3.410623509,TRUE
88695,28171,2021-07-29T06:11:28,423690486,02/07/2021 10:20,Meter,26396,27476,1080,695,6.48,3.830467372,TRUE
88610,36855,2021-07-29T06:11:28,155255555,02/07/2021 10:20,Meter,34556,35964,1408,891,9.0045,3.533947312,TRUE
89151,52162,2021-07-29T06:11:28,423367410,02/07/2021 10:20,Meter,49437,51102,1665,1060,10.854,3.487851747,TRUE
89372,28911,2021-07-29T06:11:29,1765857978,02/07/2021 10:20,Meter,26971,28118,1147,793,7.776,3.642159024,TRUE
88578,33989,2021-07-29T06:11:29,960410419,02/07/2021 10:20,Meter,31840,33122,1282,867,8.829,3.507111305,TRUE
89157,31733,2021-07-29T06:11:29,423484982,02/07/2021 10:20,Meter,29942,31002,1060,731,7.946,3.285570458,TRUE
89153,91365,2021-07-29T06:11:29,1765661613,02/07/2021 10:20,Meter,86255,89274,3019,2091,18.8352,3.964840906,TRUE
89134,32136,2021-07-29T06:11:30,960551950,02/07/2021 10:20,Meter,30360,31434,1074,702,7.652,3.276454335,TRUE
89354,37199,2021-07-29T06:11:30,155255802,02/07/2021 10:20,Meter,34899,36243,1344,956,9.4176,3.625430804,TRUE
89114,54377,2021-07-29T06:11:30,1765866623,02/07/2021 10:20,Meter,52059,53034,975,1343,12.96,3.700947972,TRUE
89661,22440,2021-07-29T06:11:31,423692462,02/07/2021 10:20,Meter,20988,21868,880,572,5.184,3.940696649,TRUE
88952,79262,2021-07-29T06:11:31,1497283986,02/07/2021 10:20,Meter,75710,77804,2094,1458,16.74,3.110599078,TRUE
88703,30211,2021-07-29T06:11:31,1497165673,02/07/2021 10:20,Meter,28822,29646,824,565,7.695,2.622296482,TRUE
88678,56345,2021-07-29T06:11:32,691910033,02/07/2021 10:20,Meter,53431,55203,1772,1142,11.34,3.596623835,TRUE
88680,23371,2021-07-29T06:11:32,691974006,02/07/2021 10:20,Meter,21918,22810,892,561,6.804,2.944696397,TRUE
89045,34472,2021-07-29T06:11:32,423445215,02/07/2021 10:20,Meter,32172,33605,1433,867,9.3465,3.312928445,TRUE
88677,26654,2021-07-29T06:11:32,691911021,02/07/2021 10:20,Meter,25160,26072,912,582,6.4746,3.210347247,TRUE
88630,30757,2021-07-29T06:11:33,155045358,02/07/2021 10:20,Meter,28804,29993,1189,764,7.3575,3.708557837,TRUE
88940,30148,2021-07-29T06:11:33,691911268,02/07/2021 10:20,Meter,28491,29497,1006,651,6.1803,3.761953303,TRUE
88885,43757,2021-07-29T06:11:33,2034095556,02/07/2021 10:20,Meter,41557,42890,1333,867,8.829,3.507111305,TRUE
88609,33357,2021-07-29T06:11:34,960389671,02/07/2021 10:20,Meter,31170,32484,1314,873,8.829,3.531381972,TRUE
88683,38802,2021-07-29T06:11:34,691974253,02/07/2021 10:20,Meter,36541,37921,1380,881,9.1233,3.448783413,TRUE
88886,44143,2021-07-29T06:11:34,423538581,02/07/2021 10:20,Meter,41677,43154,1477,989,9.072,3.89345553,TRUE
72999,27571,2021-07-29T06:11:34,960365218,02/07/2021 10:20,Meter,26334,27077,743,494,7.357,2.398104818,TRUE
88682,37022,2021-07-29T06:11:35,1228844115,02/07/2021 10:20,Meter,34931,36215,1284,807,7.6518,3.766620739,TRUE
88681,45693,2021-07-29T06:11:35,2034150390,02/07/2021 10:20,Meter,43177,44650,1473,1043,9.045,4.118297402,TRUE
88889,36270,2021-07-29T06:11:35,2034097532,02/07/2021 10:20,Meter,34112,35439,1327,831,10.044,2.954855777,TRUE
88887,34622,2021-07-29T06:11:35,2033969586,02/07/2021 10:20,Meter,32751,33888,1137,734,7.6518,3.425897921,TRUE
88605,51006,2021-07-29T06:11:36,960408690,02/07/2021 10:20,Meter,47898,49785,1887,1221,12.0663,3.613961435,TRUE
89407,37126,2021-07-29T06:11:36,1765855508,02/07/2021 10:20,Meter,34653,36159,1506,967,11.016,3.135050316,TRUE
89409,32513,2021-07-29T06:11:37,1228979224,02/07/2021 10:20,Meter,30097,31564,1467,949,11.664,2.905766216,TRUE
88369,58161,2021-07-29T06:11:37,2034078760,02/07/2021 10:20,Meter,54798,56785,1987,1376,13.338,3.684424737,TRUE
89836,43748,2021-07-29T06:11:37,423443239,02/07/2021 10:20,Meter,41082,42714,1632,1034,9.6255,3.836535393,TRUE
89870,42485,2021-07-29T06:11:37,423484735,02/07/2021 10:20,Meter,40315,41599,1284,886,9.072,3.487969262,TRUE
89876,31372,2021-07-29T06:11:38,960347681,02/07/2021 10:20,Meter,29219,30511,1292,861,9.045,3.399668325,TRUE
89397,45597,2021-07-29T06:11:38,1497400323,02/07/2021 10:20,Meter,42975,44559,1584,1038,9.3465,3.966343398,TRUE
90023,18862,2021-07-29T06:11:38,2034155824,02/07/2021 10:20,Meter,17675,18388,713,474,4.464,3.792242704,TRUE
89967,53749,2021-07-29T06:11:38,2034036523,02/07/2021 10:20,Meter,50614,52517,1903,1232,13.608,3.233392122,TRUE
89904,28910,2021-07-29T06:11:39,1497165179,02/07/2021 10:20,Meter,27062,28147,1085,763,8.064,3.37921627,TRUE
23880,38838,2021-07-29T06:11:41,1497428728,02/07/2021 10:20,Meter,37477,38271,794,567,4.374,4.62962963,TRUE
70779,36082,2021-07-29T06:11:41,423702836,02/07/2021 10:20,Meter,34361,35399,1038,683,6.21,3.927996319,TRUE
53457,90098,2021-07-29T06:11:41,692163949,02/07/2021 10:20,Meter,87371,88982,1611,1116,11.718,3.401360544,TRUE
88861,40854,2021-07-29T06:11:41,1497424035,02/07/2021 10:20,Meter,38573,39873,1300,981,9.72,3.604497354,TRUE
65370,68528,2021-07-29T06:11:42,959607422,02/07/2021 10:20,Meter,66052,67524,1472,1004,8.64,4.150132275,TRUE
89905,25559,2021-07-29T06:11:42,1765868352,02/07/2021 10:20,Meter,23861,24905,1044,654,7.776,3.003747795,TRUE
89795,66565,2021-07-29T06:11:42,1228991327,02/07/2021 10:20,Meter,62715,65053,2338,1512,16.47,3.278688525,TRUE
89073,124884,2021-07-29T06:11:42,423680606,02/07/2021 10:20,Meter,118054,122205,4151,2679,20.844,4.590221235,TRUE
90535,26820,2021-07-29T06:11:43,1497433421,02/07/2021 10:20,Meter,24990,26114,1124,706,9.648,2.61342099,TRUE
73139,49407,2021-07-29T06:11:43,2034113340,02/07/2021 10:20,Meter,47143,48478,1335,929,8.928,3.716237839,TRUE
90431,40038,2021-07-29T06:11:43,960544293,02/07/2021 10:20,Meter,37502,39030,1528,1008,9.1233,3.945940614,TRUE
90130,34241,2021-07-29T06:11:43,423673443,02/07/2021 10:20,Meter,32080,33386,1306,855,9.072,3.365929705,TRUE
89640,32479,2021-07-29T06:11:44,155196028,02/07/2021 10:20,Meter,30109,31563,1454,916,10.53,3.106769773,TRUE
90495,46195,2021-07-29T06:11:44,1497217049,02/07/2021 10:20,Meter,43463,45080,1617,1115,13.2435,3.006865902,TRUE
90441,35152,2021-07-29T06:11:44,2034269691,02/07/2021 10:20,Meter,32895,34279,1384,873,5.94,5.248917749,TRUE
90442,29416,2021-07-29T06:11:44,1228964651,02/07/2021 10:20,Meter,27351,28628,1277,788,5.94,4.737854738,TRUE
39867,41544,2021-07-29T06:11:45,1497407733,02/07/2021 10:20,Meter,40192,40993,801,551,6.21,3.168852082,TRUE
90557,40098,2021-07-29T06:11:45,1497261015,02/07/2021 10:20,Meter,37455,39048,1593,1050,11.025,3.401360544,TRUE
88907,39837,2021-07-29T06:11:45,423680853,02/07/2021 10:20,Meter,37812,39038,1226,799,8.811,3.238646497,TRUE
90252,24721,2021-07-29T06:11:45,2034124702,02/07/2021 10:20,Meter,23084,24094,1010,627,6.93,3.231292517,TRUE
90337,56788,2021-07-29T06:11:46,155007320,02/07/2021 10:20,Meter,53767,55606,1839,1182,11.664,3.619194591,TRUE
90336,39882,2021-07-29T06:11:46,423357036,02/07/2021 10:20,Meter,36977,38713,1736,1169,12.3606,3.377667751,TRUE
90338,65806,2021-07-29T06:11:46,2034151131,02/07/2021 10:20,Meter,62085,64352,2267,1454,13.833,3.75396309,TRUE
90141,34105,2021-07-29T06:11:46,1765850074,02/07/2021 10:20,Meter,32047,33344,1297,761,7.236,3.75602148,TRUE
90150,24808,2021-07-29T06:11:47,1497420577,02/07/2021 10:20,Meter,23133,24163,1030,645,8.784,2.62246292,TRUE
56103,32142,2021-07-29T06:11:48,2034316127,02/07/2021 10:20,Meter,30746,31577,831,565,6.804,2.96569245,TRUE
90983,19528,2021-07-29T06:11:49,155076727,02/07/2021 10:20,Meter,18245,18988,743,540,5.265,3.663003663,TRUE
86461,38799,2021-07-29T06:11:49,1497391925,02/07/2021 10:20,Meter,36646,37959,1313,840,8.762,3.423875827,TRUE
91256,41456,2021-07-29T06:11:49,1228730001,02/07/2021 10:20,Meter,38259,40143,1884,1313,12.312,3.808711594,TRUE
90901,35255,2021-07-29T06:11:49,2034173608,02/07/2021 10:20,Meter,32856,34315,1459,940,7.128,4.709796376,TRUE
91427,37902,2021-07-29T06:11:50,2034094568,02/07/2021 10:20,Meter,35858,37107,1249,795,7.875,3.605442177,TRUE
91579,34254,2021-07-29T06:11:50,960354844,02/07/2021 10:20,Meter,31860,33309,1449,945,8.829,3.822629969,TRUE
91422,43613,2021-07-29T06:11:50,423484241,02/07/2021 10:21,Meter,40990,42533,1543,1080,9.123,4.227932541,TRUE
91429,35588,2021-07-29T06:11:50,1497222236,02/07/2021 10:21,Meter,33258,34683,1425,905,8.829,3.660825526,TRUE
91421,29343,2021-07-29T06:11:51,155082902,02/07/2021 10:21,Meter,27412,28591,1179,752,7.6518,3.509911767,TRUE
91609,41285,2021-07-29T06:11:51,960561830,02/07/2021 10:21,Meter,38740,40256,1516,1029,6.372,5.767419962,TRUE
91433,35362,2021-07-29T06:11:51,2034080736,02/07/2021 10:21,Meter,33036,34446,1410,916,9.45,3.461829176,TRUE
91426,45731,2021-07-29T06:11:51,423482018,02/07/2021 10:21,Meter,42783,44588,1805,1143,12.3606,3.302544259,TRUE
90956,33002,2021-07-29T06:11:52,155045111,02/07/2021 10:21,Meter,30788,32142,1354,860,8.829,3.478795528,TRUE
90754,25384,2021-07-29T06:11:52,423480536,02/07/2021 10:21,Meter,23773,24747,974,637,5.886,3.865103636,TRUE
90709,26614,2021-07-29T06:11:52,423487452,02/07/2021 10:21,Meter,24912,25937,1025,677,6.1803,3.912200286,TRUE
91423,41293,2021-07-29T06:11:52,691910774,02/07/2021 10:21,Meter,38639,40261,1622,1032,10.1286,3.638917803,TRUE
91034,39939,2021-07-29T06:11:55,1497412920,03/07/2021 10:10,Meter,37740,39083,1343,856,9.1233,3.350917823,TRUE
91569,41074,2021-07-29T06:11:56,960226898,03/07/2021 10:10,Meter,38478,40072,1594,1002,11.156,3.207754956,TRUE
90806,24227,2021-07-29T06:11:56,960352868,03/07/2021 10:10,Meter,22818,23683,865,544,5.832,3.331373702,TRUE
91424,24310,2021-07-29T06:11:56,2034088393,03/07/2021 10:10,Meter,22817,23716,899,594,5.297,4.004962378,TRUE
90710,37105,2021-07-29T06:11:56,1765856002,03/07/2021 10:10,Meter,34615,36102,1487,1003,9.1233,3.926367495,TRUE
91428,29661,2021-07-29T06:11:57,1228781130,03/07/2021 10:10,Meter,27965,29001,1036,660,6.03,3.909026297,TRUE
90933,10831,2021-07-29T06:11:57,960371640,03/07/2021 10:10,Meter,10246,10594,348,237,2.7,3.134920635,TRUE
91496,39813,2021-07-29T06:11:57,1228998243,03/07/2021 10:10,Meter,36912,38659,1747,1154,11.997,3.435382655,TRUE
91615,27082,2021-07-29T06:11:57,423691227,03/07/2021 10:10,Meter,24954,26235,1281,847,9.072,3.334435626,TRUE
88636,13590,2021-07-29T06:11:58,423691721,03/07/2021 10:10,Meter,12732,13258,526,332,3.726,3.182271298,TRUE
90941,62373,2021-07-29T06:11:58,1228845844,03/07/2021 10:10,Meter,59100,61045,1945,1328,12.96,3.659611993,TRUE
90953,20010,2021-07-29T06:11:58,423674678,03/07/2021 10:10,Meter,18726,19515,789,495,6.48,2.728174603,TRUE
91595,35986,2021-07-29T06:11:58,2034287969,03/07/2021 10:10,Meter,33449,34979,1530,1007,9.6255,3.736355069,TRUE
90759,36210,2021-07-29T06:11:59,692073547,03/07/2021 10:10,Meter,34091,35340,1249,870,7.776,3.995811287,TRUE
90949,24052,2021-07-29T06:11:59,423638122,03/07/2021 10:10,Meter,22570,23458,888,594,7.128,2.976190476,TRUE
90758,59947,2021-07-29T06:11:59,2034294391,03/07/2021 10:10,Meter,56150,58385,2235,1562,13.5675,4.11171655,TRUE
90954,18734,2021-07-29T06:12:01,155196769,03/07/2021 10:10,Meter,17565,18249,684,485,4.536,3.818657092,TRUE
90583,13998,2021-07-29T06:12:01,1497374141,03/07/2021 10:10,Meter,13143,13646,503,352,3.888,3.233392122,TRUE
91084,20323,2021-07-29T06:12:01,2034151872,03/07/2021 10:10,Meter,19025,19812,787,511,5.13,3.557504873,TRUE
90946,19805,2021-07-29T06:12:02,423582794,03/07/2021 10:10,Meter,18654,19340,686,465,4.7088,3.526831222,TRUE
91036,19887,2021-07-29T06:12:02,155029056,03/07/2021 10:10,Meter,18438,19324,886,563,5.729,3.50971249,TRUE
89894,52389,2021-07-29T06:12:06,1228955759,03/07/2021 10:11,Meter,48816,50963,2147,1426,13.23,3.849476298,TRUE
4585,48325,2021-07-29T06:12:08,960501562,03/07/2021 10:11,Meter,45493,47092,1599,1233,11.907,3.698304719,TRUE
90098,23870,2021-07-29T06:12:08,423691474,03/07/2021 10:11,Meter,22033,23158,1125,712,7.452,3.412315007,TRUE
90716,25105,2021-07-29T06:12:08,960355091,03/07/2021 10:11,Meter,23500,24465,965,640,6.156,3.712986169,TRUE
8717,47168,2021-07-29T06:12:08,692128875,03/07/2021 10:11,Meter,44376,46067,1691,1101,10.368,3.792576058,TRUE
16230,111338,2021-07-29T06:12:09,960556396,03/07/2021 10:11,Meter,104321,107991,3670,3347,21.6,5.534060847,TRUE
38770,25838,2021-07-29T06:12:09,1228938716,03/07/2021 10:11,Meter,23959,25116,1157,722,8.316,3.100735244,TRUE
47039,50728,2021-07-29T06:12:09,1765752756,03/07/2021 10:11,Meter,49086,50052,966,676,5.76,4.191468254,TRUE
90280,37425,2021-07-29T06:12:10,1765825127,03/07/2021 10:11,Meter,35748,36944,1196,481,8.352,2.056821292,TRUE
91937,32831,2021-07-29T06:12:10,423671714,03/07/2021 10:11,Meter,30493,31888,1395,943,8.505,3.959855547,TRUE
92481,46274,2021-07-29T06:12:13,960347928,03/07/2021 10:11,Meter,43175,45033,1858,1241,11.457,3.868502101,TRUE
50093,47040,2021-07-29T06:12:13,691166563,03/07/2021 10:11,Meter,45538,46391,853,649,7.9461,2.916974545,TRUE
91845,48359,2021-07-29T06:12:13,1765855261,03/07/2021 10:11,Meter,45002,46985,1983,1374,13.536,3.625253293,TRUE
92321,42109,2021-07-29T06:12:13,691809010,03/07/2021 10:11,Meter,39479,41089,1610,1020,10.044,3.626898788,TRUE
92483,22100,2021-07-29T06:12:21,1228876472,03/07/2021 10:11,Meter,20607,21494,887,606,5.5917,3.870532601,TRUE
92641,40979,2021-07-29T06:12:22,1765836489,03/07/2021 10:11,Meter,38000,39755,1755,1224,9.3465,4.677075452,TRUE
92600,23647,2021-07-29T06:12:22,423452378,03/07/2021 10:11,Meter,22091,23053,962,594,5.184,4.092261905,TRUE
10314,20012,2021-07-29T06:12:22,155248392,03/07/2021 10:11,Meter,18949,19590,641,422,5.4,2.791005291,TRUE
92065,34521,2021-07-29T06:12:22,691791720,03/07/2021 10:11,Meter,32323,33669,1346,852,9.045,3.364131722,TRUE
92064,27264,2021-07-29T06:12:23,2034100002,03/07/2021 10:11,Meter,25154,26443,1289,821,8.5347,3.435554685,TRUE
92255,29944,2021-07-29T06:12:23,1497320295,03/07/2021 10:11,Meter,27849,29080,1231,864,8.829,3.494975972,TRUE
92266,89057,2021-07-29T06:12:23,960551703,03/07/2021 10:11,Meter,83662,86890,3228,2167,19.44,3.981114051,TRUE
92329,20779,2021-07-29T06:12:23,960548986,03/07/2021 10:11,Meter,19318,20186,868,593,5.184,4.085372575,TRUE
92442,18478,2021-07-29T06:12:24,1497427246,03/07/2021 10:11,Meter,17385,18047,662,431,5.003,3.076725393,TRUE
92625,30479,2021-07-29T06:12:24,423675419,03/07/2021 10:11,Meter,28144,29538,1394,941,10.044,3.345991921,TRUE
92310,14919,2021-07-29T06:12:24,2034100496,03/07/2021 10:11,Meter,14006,14543,537,376,3.888,3.453850676,TRUE
92323,48198,2021-07-29T06:12:24,692110844,03/07/2021 10:11,Meter,45422,47085,1663,1113,10.368,3.833912037,TRUE
92193,51693,2021-07-29T06:12:25,692110103,03/07/2021 10:11,Meter,48750,50730,1980,963,13.608,2.527399849,TRUE
92519,10218,2021-07-29T06:12:25,1497419836,03/07/2021 10:11,Meter,9447,9914,467,304,3.888,2.792475015,TRUE
92421,17498,2021-07-29T06:12:25,423673690,03/07/2021 10:11,Meter,16383,17059,676,439,4.824,3.250118455,TRUE
92212,24978,2021-07-29T06:12:26,423632441,03/07/2021 10:11,Meter,23526,24382,856,596,5.832,3.649813835,TRUE
69980,32647,2021-07-29T06:12:26,959622242,03/07/2021 10:11,Meter,31337,32104,767,543,5.886,3.294742974,TRUE
92912,29453,2021-07-29T06:12:26,692120971,03/07/2021 10:11,Meter,27409,28642,1233,811,8.2404,3.514912591,TRUE
80243,50911,2021-07-29T06:12:26,692083427,03/07/2021 10:11,Meter,48313,49877,1564,1034,9.504,3.885582011,TRUE
90865,48460,2021-07-29T06:12:32,1228667016,03/07/2021 10:11,Meter,45630,47305,1675,1155,11.16,3.696236559,TRUE
26008,69187,2021-07-29T06:12:33,1228054209,03/07/2021 10:11,Meter,66979,68296,1317,891,8.262,3.851540616,TRUE
92389,25881,2021-07-29T06:12:33,960530955,03/07/2021 10:11,Meter,23894,25112,1218,769,9.072,3.027368355,TRUE
92440,40807,2021-07-29T06:12:33,960453891,03/07/2021 10:11,Meter,38120,39768,1648,1039,11.016,3.36847702,TRUE
92438,27354,2021-07-29T06:12:34,2034304518,03/07/2021 10:11,Meter,25491,26587,1096,767,6.48,4.227292769,TRUE
93306,25542,2021-07-29T06:12:34,960453644,03/07/2021 10:11,Meter,23611,24727,1116,815,8.829,3.296765529,TRUE
93566,47040,2021-07-29T06:12:34,692018219,03/07/2021 10:11,Meter,43465,45637,2172,1403,14.04,3.568884819,TRUE
92437,40733,2021-07-29T06:12:35,1497432680,03/07/2021 10:12,Meter,37964,39617,1653,1116,11.664,3.417107584,TRUE
93509,26992,2021-07-29T06:12:35,2034077772,03/07/2021 10:12,Meter,25126,26249,1123,743,6.633,4.000559971,TRUE
93641,30237,2021-07-29T06:12:37,1765659143,03/07/2021 10:12,Meter,28194,29440,1246,797,8.829,3.22395353,TRUE
93435,43884,2021-07-29T06:12:37,1228999725,03/07/2021 10:12,Meter,40918,42695,1777,1189,10.692,3.971594249,TRUE
93624,31399,2021-07-29T06:12:38,692110597,03/07/2021 10:12,Meter,29109,30509,1400,890,9.1233,3.484015026,TRUE
93210,22371,2021-07-29T06:12:38,2034184970,03/07/2021 10:12,Meter,20934,21782,848,589,5.94,3.541366041,TRUE
91618,38716,2021-07-29T06:12:38,1228999478,03/07/2021 10:12,Meter,36451,37821,1370,895,8.748,3.653896401,TRUE
91613,18277,2021-07-29T06:12:38,1765867611,03/07/2021 10:12,Meter,16999,17639,640,638,4.725,4.822373394,TRUE
93689,18616,2021-07-29T06:12:39,155256296,03/07/2021 10:12,Meter,17078,18025,947,591,8.424,2.505596256,TRUE
93687,23942,2021-07-29T06:12:39,1497434409,03/07/2021 10:12,Meter,21435,22946,1511,996,9.135,3.893971382,TRUE
93911,14888,2021-07-29T06:12:39,1228986387,03/07/2021 10:12,Meter,13492,14264,772,624,6.3,3.537414966,TRUE
93232,18120,2021-07-29T06:12:39,154950016,03/07/2021 10:12,Meter,16789,17609,820,511,6.4746,2.818706947,TRUE
88613,12651,2021-07-29T06:12:40,1765858966,03/07/2021 10:12,Meter,11917,12358,441,293,3.456,3.02786045,TRUE
93202,33646,2021-07-29T06:12:40,1497373400,03/07/2021 10:12,Meter,31047,32633,1586,1013,11.34,3.190350214,TRUE
93727,35535,2021-07-29T06:12:42,1765869587,03/07/2021 10:12,Meter,33278,34648,1370,887,8.82,3.591674765,TRUE
92751,12810,2021-07-29T06:12:43,960550962,03/07/2021 10:12,Meter,12167,12542,375,268,4.464,2.144137225,TRUE
93433,23570,2021-07-29T06:12:43,960564053,03/07/2021 10:12,Meter,21816,22901,1085,669,6.48,3.687169312,TRUE
94173,26017,2021-07-29T06:12:44,423543027,03/07/2021 10:12,Meter,24017,25197,1180,820,9.1233,3.209991372,TRUE
94111,10944,2021-07-29T06:12:44,1497423294,03/07/2021 10:12,Meter,9919,10542,623,402,4.743,3.027017259,TRUE
65725,56424,2021-07-29T06:12:44,1765880455,03/07/2021 10:12,Meter,54077,55461,1384,963,8.829,3.895441969,TRUE
93157,37679,2021-07-29T06:12:44,1497434656,03/07/2021 10:12,Meter,35418,36791,1373,888,9.135,3.471733521,TRUE
94352,26295,2021-07-29T06:12:45,1229038257,03/07/2021 10:12,Meter,24162,25442,1280,853,9.765,3.119742521,TRUE
94497,26197,2021-07-29T06:12:45,155131808,03/07/2021 10:12,Meter,24329,25472,1143,725,5.94,4.359066859,TRUE
89399,37119,2021-07-29T06:12:45,155256049,03/07/2021 10:12,Meter,35030,36298,1268,821,8.775,3.341473341,TRUE
94491,42962,2021-07-29T06:12:45,1228985893,03/07/2021 10:12,Meter,40041,41737,1696,1225,12.06,3.627694859,TRUE
55187,46278,2021-07-29T06:12:46,1765862671,03/07/2021 10:12,Meter,44542,45580,1038,698,8.073,3.087894392,TRUE
94283,35380,2021-07-29T06:12:46,423465469,03/07/2021 10:12,Meter,32884,34368,1484,1012,9.1233,3.961599108,TRUE
94158,28633,2021-07-29T06:12:46,423631700,03/07/2021 10:12,Meter,26316,27717,1401,916,11.016,2.969706401,TRUE
94319,30149,2021-07-29T06:12:46,423465222,03/07/2021 10:12,Meter,28230,29393,1163,756,7.182,3.759398496,TRUE
91860,21969,2021-07-29T06:12:47,960385225,03/07/2021 10:12,Meter,20266,21282,1016,687,5.85,4.194139194,TRUE
93724,24687,2021-07-29T06:12:47,1228999231,03/07/2021 10:12,Meter,22935,23995,1060,692,6.93,3.566274995,TRUE
94892,29147,2021-07-29T06:12:47,691900647,03/07/2021 10:12,Meter,26694,28170,1476,977,12.06,2.893271737,TRUE
94766,21010,2021-07-29T06:12:47,1765808825,03/07/2021 10:12,Meter,19434,20363,929,647,7.0632,3.271483585,TRUE
94895,24558,2021-07-29T06:12:48,1228981694,03/07/2021 10:12,Meter,22599,23789,1190,769,8.748,3.139493109,TRUE
94792,28914,2021-07-29T06:12:48,155296557,03/07/2021 10:12,Meter,26380,27895,1515,1019,11.439,3.181471907,TRUE
95043,28595,2021-07-29T06:12:48,960502797,03/07/2021 10:12,Meter,26646,27821,1175,774,7.56,3.656462585,TRUE
94994,41465,2021-07-29T06:12:48,1229038998,03/07/2021 10:12,Meter,38446,40255,1809,1210,12.555,3.441998066,TRUE
91655,22437,2021-07-29T06:12:49,423691968,03/07/2021 10:12,Meter,20672,21733,1061,704,8.505,2.956244226,TRUE
92558,33151,2021-07-29T06:12:49,155235548,03/07/2021 10:12,Meter,30642,32139,1497,1012,10.395,3.476946334,TRUE
94655,27192,2021-07-29T06:12:49,960554420,03/07/2021 10:12,Meter,24086,25970,1884,1222,11.232,3.885582011,TRUE
94646,52467,2021-07-29T06:12:49,1228806324,03/07/2021 10:12,Meter,50059,51488,1429,979,9.234,3.786472354,TRUE
94094,23975,2021-07-29T06:12:50,1497428975,03/07/2021 10:12,Meter,17503,23168,5665,807,8.748,3.294630609,TRUE
94093,33625,2021-07-29T06:12:50,1765870081,03/07/2021 10:12,Meter,24543,32774,8231,851,10.044,3.02597144,TRUE
95317,11433,2021-07-29T06:12:50,1228771497,03/07/2021 10:12,Meter,10450,11032,582,401,3.591,3.988144966,TRUE
95156,31805,2021-07-29T06:12:51,1228783106,03/07/2021 10:12,Meter,28374,30347,1973,1458,13.95,3.732718894,TRUE
95471,30659,2021-07-29T06:12:51,691900894,03/07/2021 10:12,Meter,28616,29821,1205,838,7.236,4.136065703,TRUE
95398,26149,2021-07-29T06:12:51,692167407,03/07/2021 10:12,Meter,24154,25323,1169,826,8.37,3.524492234,TRUE
95274,26201,2021-07-29T06:12:51,155236289,03/07/2021 10:12,Meter,24295,25448,1153,753,7.56,3.557256236,TRUE
76005,51857,2021-07-29T06:12:52,1228048528,03/07/2021 10:12,Meter,49080,50748,1668,1109,11.07,3.577881017,TRUE
55816,17874,2021-07-29T06:12:52,155296804,03/07/2021 10:12,Meter,16544,17347,803,527,4.86,3.872721928,TRUE
95160,26282,2021-07-29T06:12:53,2034296861,03/07/2021 10:12,Meter,24187,25464,1277,818,8.64,3.381283069,TRUE
95280,10952,2021-07-29T06:12:53,155245181,03/07/2021 10:12,Meter,10244,10586,342,366,8.64,1.512896825,TRUE
94775,53176,2021-07-29T06:12:54,691973265,03/07/2021 10:12,Meter,49847,51879,2032,1297,11.16,4.150665643,TRUE
95067,40700,2021-07-29T06:12:54,1228997008,03/07/2021 10:12,Meter,38122,39673,1551,1027,9.72,3.773515579,TRUE
94910,36707,2021-07-29T06:12:54,960553432,03/07/2021 10:12,Meter,33961,35598,1637,1109,11.169,3.546167325,TRUE
5266,39123,2021-07-29T06:12:55,1765864153,03/07/2021 10:12,Meter,29167,37726,8559,1397,12.821,3.89149498,TRUE
96384,30335,2021-07-29T06:12:55,154989042,03/07/2021 10:12,Meter,28581,29572,991,763,13.05,2.088122605,TRUE
96528,28971,2021-07-29T06:12:55,960288401,03/07/2021 10:12,Meter,26224,27887,1663,1084,13.284,2.91435454,TRUE
96452,19318,2021-07-29T06:12:55,155290135,03/07/2021 10:12,Meter,17948,18775,827,543,4.455,4.353054353,TRUE
86584,1845,2021-07-29T06:12:56,1765903179,02/07/2021 8:45,Meter,721,1396,675,449,4.7088,3.405477889,TRUE
94536,36301,2021-07-29T06:12:57,423617374,03/07/2021 10:12,Meter,33796,35250,1454,1051,8.91,4.212762546,TRUE
92072,30549,2021-07-29T06:12:58,1765862177,03/07/2021 10:12,Meter,29277,29817,540,732,8.784,2.976190476,TRUE
96795,29979,2021-07-29T06:12:58,691915220,03/07/2021 10:12,Meter,27979,29200,1221,779,7.128,3.903118486,TRUE
94971,20913,2021-07-29T06:12:58,1765910095,03/07/2021 10:12,Meter,19432,20325,893,588,6.75,3.111111111,TRUE
95969,19372,2021-07-29T06:12:58,2034305506,03/07/2021 10:12,Meter,17842,18772,930,600,5.7375,3.734827264,TRUE
96666,27223,2021-07-29T06:12:59,960335578,03/07/2021 10:12,Meter,24940,26295,1355,928,8.829,3.753863081,TRUE
96701,37215,2021-07-29T06:12:59,1497405263,02/07/2021 8:44,Meter,29310,36232,6922,983,9.72,3.611845973,TRUE
94309,20723,2021-07-29T06:12:59,1765867364,03/07/2021 10:12,Meter,19160,20110,950,613,6.615,3.309577799,TRUE
96769,44224,2021-07-29T06:13:00,155257531,03/07/2021 10:12,Meter,40614,42743,2129,1481,10.368,5.101548721,TRUE
96770,33584,2021-07-29T06:13:00,960562077,03/07/2021 10:12,Meter,30894,32478,1584,1106,8.496,4.649246704,TRUE
91565,34876,2021-07-29T06:13:00,154942606,03/07/2021 10:12,Meter,32532,33916,1384,960,9.123,3.758162259,TRUE
79212,38063,2021-07-29T06:13:00,960586283,03/07/2021 10:12,Meter,36210,37342,1132,721,6.804,3.784538507,TRUE
96899,16186,2021-07-29T06:13:01,692168642,03/07/2021 10:12,Meter,14900,15682,782,504,5.301,3.395585739,TRUE
96466,23231,2021-07-29T06:13:01,960290130,03/07/2021 10:12,Meter,21728,22604,876,627,5.1255,4.368911744,TRUE
91558,17894,2021-07-29T06:13:01,2034339839,03/07/2021 10:12,Meter,16681,17411,730,483,5.94,2.904040404,TRUE
20829,21180,2021-07-29T06:13:02,1228662076,03/07/2021 10:12,Meter,19500,20518,1018,662,6.332,3.733868784,TRUE
96895,48467,2021-07-29T06:13:02,2034303530,03/07/2021 10:12,Meter,45069,47059,1990,1408,13.77,3.651831103,TRUE
97104,33723,2021-07-29T06:13:02,155250615,03/07/2021 10:12,Meter,31125,32674,1549,1049,9.72,3.854350382,TRUE
88262,17617,2021-07-29T06:13:02,1228986881,03/07/2021 10:12,Meter,16801,17318,517,299,5.724,1.865578517,TRUE
90434,62671,2021-07-29T06:13:03,1228816204,03/07/2021 10:12,Meter,59121,61204,2083,1467,13.5,3.880952381,TRUE
95313,29944,2021-07-29T06:13:03,960300010,03/07/2021 10:12,Meter,27175,28857,1682,1087,9.72,3.993974133,TRUE
97109,21363,2021-07-29T06:13:03,423727042,03/07/2021 10:12,Meter,19935,20885,950,478,5.508,3.099387903,TRUE
96796,24562,2021-07-29T06:13:04,1229033317,03/07/2021 10:12,Meter,22786,23862,1076,700,7.128,3.507295174,TRUE
96419,23001,2021-07-29T06:13:04,960545528,03/07/2021 10:13,Meter,20944,22186,1242,815,8.748,3.327291136,TRUE
17798,21370,2021-07-29T06:13:04,2034338604,03/07/2021 10:13,Meter,19597,20692,1095,678,7.063,3.428328715,TRUE
94945,37592,2021-07-29T06:13:05,423496344,03/07/2021 10:13,Meter,34754,36448,1694,1144,10.656,3.834191334,TRUE
97245,25920,2021-07-29T06:13:05,423733217,03/07/2021 10:13,Meter,23754,25063,1309,857,8.442,3.625579585,TRUE
42994,57486,2021-07-29T06:13:05,423358518,03/07/2021 10:13,Meter,55983,56895,912,591,7.0632,2.988325809,TRUE
97260,26118,2021-07-29T06:13:10,155274080,03/07/2021 10:13,Meter,23957,25267,1310,851,7.6995,3.947380628,TRUE
96934,29309,2021-07-29T06:13:11,1229033564,03/07/2021 10:13,Meter,26986,28396,1410,913,10.368,3.144979056,TRUE
83684,27298,2021-07-29T06:13:11,2034178548,03/07/2021 10:13,Meter,25177,26454,1277,844,7.839,3.845242651,TRUE
91861,21028,2021-07-29T06:13:11,960293588,03/07/2021 10:13,Meter,18972,20202,1230,826,8.82,3.344671202,TRUE
54408,33472,2021-07-29T06:13:11,155254814,03/07/2021 10:13,Meter,30307,32236,1929,1236,12.11,3.645157485,TRUE
69101,22450,2021-07-29T06:13:14,960587024,03/07/2021 10:13,Meter,20399,21622,1223,828,8.829,3.349351973,TRUE
66686,33751,2021-07-29T06:13:14,960318041,03/07/2021 10:13,Meter,32112,33110,998,641,6.633,3.451357929,TRUE
88725,23329,2021-07-29T06:13:14,1497390196,03/07/2021 10:13,Meter,21702,22710,1008,619,6.048,3.655281557,TRUE
48020,57092,2021-07-29T06:13:14,2034316374,03/07/2021 10:13,Meter,55003,56245,1242,847,9.72,3.112139918,TRUE
39596,173141,2021-07-29T06:13:15,155288406,03/07/2021 10:13,Meter,167296,170867,3571,2274,25.2,3.222789116,TRUE
38822,60025,2021-07-29T06:13:15,960306432,03/07/2021 10:13,Meter,58277,59336,1059,689,7.056,3.487406868,TRUE
6354,77430,2021-07-29T06:13:15,691812715,03/07/2021 10:13,Meter,76130,76906,776,524,7.452,2.511310482,TRUE
88558,30367,2021-07-29T06:13:15,155065612,03/07/2021 10:13,Meter,28684,29710,1026,657,6.804,3.448601663,TRUE
18937,13972,2021-07-29T06:13:16,1497459109,03/07/2021 10:13,Meter,12694,13484,790,488,5.382,3.238307586,TRUE
54752,34155,2021-07-29T06:13:16,1765696687,03/07/2021 10:13,Meter,32596,33551,955,604,6.21,3.473659995,TRUE
21301,15268,2021-07-29T06:13:16,155297545,03/07/2021 10:13,Meter,13413,14527,1114,741,6.93,3.818800247,TRUE
88632,35119,2021-07-29T06:13:16,1497178517,03/07/2021 10:13,Meter,33035,34269,1234,850,7.236,4.195293374,TRUE
47258,80877,2021-07-29T06:13:17,155273339,03/07/2021 10:13,Meter,78116,79802,1686,1075,10.8,3.55489418,TRUE
61070,46179,2021-07-29T06:13:17,1228875731,03/07/2021 10:13,Meter,44902,45696,794,483,8.775,1.965811966,TRUE
81023,64504,2021-07-29T06:13:17,1229020473,03/07/2021 10:13,Meter,61374,63541,2167,963,13.608,2.527399849,TRUE
81602,16002,2021-07-29T06:13:18,959610386,03/07/2021 10:13,Meter,15010,15616,606,386,3.564,3.868045535,TRUE
92711,19475,2021-07-29T06:13:18,692164690,03/07/2021 10:13,Meter,16458,18284,1826,1191,7.776,5.470127866,TRUE
14844,12322,2021-07-29T06:13:18,1765545276,03/07/2021 10:13,Meter,10883,11737,854,585,6.3,3.316326531,TRUE
90957,33539,2021-07-29T06:13:20,154295960,03/07/2021 10:13,Meter,31959,32926,967,613,8.24,2.656900139,TRUE
46933,69126,2021-07-29T06:13:20,422739042,03/07/2021 10:13,Meter,66340,67875,1535,1251,12.0663,3.702756556,TRUE
54407,60347,2021-07-29T06:13:20,1496493339,03/07/2021 10:13,Meter,57779,59308,1529,1039,9.4176,3.94019101,TRUE
46859,68160,2021-07-29T06:13:21,422731138,03/07/2021 10:13,Meter,65735,67165,1430,995,9.7119,3.658986839,TRUE
56159,70789,2021-07-29T06:13:21,422738795,03/07/2021 10:13,Meter,68110,69671,1561,1118,8.982,4.445398734,TRUE
87832,14172,2021-07-29T06:13:21,960580849,03/07/2021 10:13,Meter,13117,13746,629,426,3.78,4.024943311,TRUE
81397,39269,2021-07-29T06:13:22,1496471603,03/07/2021 10:13,Meter,36799,38310,1511,959,10.854,3.155518703,TRUE
52251,130425,2021-07-29T06:13:23,1496480742,03/07/2021 10:13,Meter,123894,127852,3958,2573,29.025,3.16598991,TRUE
66533,55938,2021-07-29T06:13:24,2033359496,03/07/2021 10:13,Meter,53483,54969,1486,969,9.72,3.560405644,TRUE
71850,46393,2021-07-29T06:13:24,2033349616,03/07/2021 10:13,Meter,44534,45652,1118,741,6.264,4.224822113,TRUE
92487,65521,2021-07-29T06:13:24,154303370,03/07/2021 10:13,Meter,62450,64298,1848,1223,13.833,3.157563177,TRUE
76157,42518,2021-07-29T06:13:24,1765868105,03/07/2021 10:13,Meter,40204,41629,1425,889,10.944,2.901133041,TRUE
91913,43744,2021-07-29T06:13:25,1765870575,03/07/2021 10:13,Meter,40773,42583,1810,1161,12.69,3.267477204,TRUE
20915,6813,2021-07-29T06:13:25,959620266,03/07/2021 10:13,Meter,5292,6210,918,603,5.733,3.756447634,TRUE
63139,64740,2021-07-29T06:13:25,2033342453,03/07/2021 10:13,Meter,61985,63627,1642,1113,10.26,3.874269006,TRUE
60297,73028,2021-07-29T06:13:25,692107880,03/07/2021 10:13,Meter,70470,71976,1506,1052,11.1834,3.359571201,TRUE
17725,71141,2021-07-29T06:13:28,1228042847,03/07/2021 10:13,Meter,69117,70320,1203,821,6.633,4.420538003,TRUE
87252,47947,2021-07-29T06:13:37,960533919,03/07/2021 10:13,Meter,19420,20750,1330,27197,14.85,65.40885041,TRUE
